strategy,money,countries,utilities,stations,totalLandsOwned
GREEDY,29529,8,2,0,10
DEFAULT,60077,5,0,2,7
UTILITY_GUY,56441,9,0,1,10
UTILITY_GUY,29768,7,1,1,9
UTILITY_GUY,56438,8,1,0,9
STATION_GUY,39801,5,0,0,5
STATION_GUY,9601,4,0,0,4
GREEDY,23182,12,1,2,15
GREEDY,16038,8,1,1,10
GREEDY,16651,7,1,1,9
STATION_GUY,26739,7,0,1,8
GREEDY,16332,11,0,1,12
GREEDY,27660,6,1,2,9
UTILITY_GUY,47885,2,0,1,3
GREEDY,18905,7,0,3,10
GREEDY,19251,6,0,0,6
DEFAULT,69262,8,0,0,8
STATION_GUY,94701,5,0,2,7
UTILITY_GUY,69320,6,0,0,6
DEFAULT,47013,8,0,0,8
GREEDY,60297,8,2,2,12
GREEDY,40444,9,0,2,11
GREEDY,12139,8,0,2,10
GREEDY,12243,6,1,0,7
GREEDY,21113,8,1,1,10
GREEDY,33268,7,0,0,7
UTILITY_GUY,41323,5,1,0,6
GREEDY,20086,10,0,2,12
GREEDY,37730,10,1,1,12
GREEDY,22297,9,0,1,10
GREEDY,20373,10,0,1,11
GREEDY,16548,8,1,0,9
GREEDY,76138,10,0,1,11
GREEDY,26401,9,0,1,10
GREEDY,45780,8,1,2,11
GREEDY,57822,10,1,0,11
GREEDY,16842,11,1,1,13
GREEDY,32735,11,1,0,12
GREEDY,59505,7,0,2,9
GREEDY,23061,11,0,1,12
GREEDY,9884,5,1,3,9
GREEDY,30108,5,0,0,5
UTILITY_GUY,34742,6,1,1,8
GREEDY,19545,12,0,1,13
GREEDY,15714,8,0,4,12
GREEDY,10483,9,0,1,10
GREEDY,10722,6,0,1,7
GREEDY,11697,9,0,2,11
GREEDY,20884,5,1,1,7
DEFAULT,38924,5,0,2,7
UTILITY_GUY,44230,9,1,0,10
GREEDY,14503,8,0,2,10
GREEDY,22397,11,0,1,12
GREEDY,17706,8,1,1,10
GREEDY,32194,8,0,0,8
UTILITY_GUY,61547,5,0,1,6
GREEDY,25604,8,1,1,10
GREEDY,23128,8,0,0,8
GREEDY,22947,7,0,2,9
DEFAULT,51161,7,0,2,9
DEFAULT,44947,4,0,2,6
GREEDY,43113,9,2,1,12
STATION_GUY,69336,7,0,1,8
GREEDY,39241,8,0,0,8
GREEDY,75170,11,1,2,14
GREEDY,24428,7,0,1,8
GREEDY,18609,11,1,2,14
GREEDY,24721,7,1,0,8
DEFAULT,46320,7,0,0,7
GREEDY,10395,7,0,1,8
STATION_GUY,78602,6,0,1,7
UTILITY_GUY,60233,5,0,1,6
DEFAULT,26423,8,1,0,9
STATION_GUY,22756,4,1,1,6
STATION_GUY,67233,8,1,0,9
UTILITY_GUY,39979,4,1,2,7
GREEDY,22456,7,0,1,8
STATION_GUY,52552,8,0,2,10
GREEDY,18133,12,0,1,13
GREEDY,22745,8,1,2,11
UTILITY_GUY,29733,5,0,1,6
GREEDY,15290,8,1,0,9
DEFAULT,29093,8,1,0,9
GREEDY,20553,10,0,1,11
GREEDY,29097,7,0,0,7
GREEDY,27312,10,1,1,12
GREEDY,12185,6,1,2,9
GREEDY,28715,7,0,0,7
DEFAULT,28945,9,0,1,10
GREEDY,16583,8,2,1,11
GREEDY,9444,10,0,1,11
DEFAULT,21736,6,1,0,7
STATION_GUY,65353,8,1,0,9
DEFAULT,39957,5,0,1,6
UTILITY_GUY,47018,6,0,1,7
GREEDY,31997,8,0,1,9
GREEDY,27070,8,0,0,8
STATION_GUY,57459,10,0,0,10
GREEDY,16788,8,1,3,12
STATION_GUY,53322,6,0,1,7
GREEDY,23095,9,2,0,11
GREEDY,45213,8,1,2,11
DEFAULT,37009,7,0,1,8
GREEDY,19127,10,1,1,12
DEFAULT,50229,8,0,1,9
STATION_GUY,85539,7,0,2,9
GREEDY,67941,8,1,2,11
GREEDY,23335,9,1,1,11
GREEDY,24960,8,1,1,10
STATION_GUY,72020,9,1,1,11
GREEDY,25528,11,1,1,13
DEFAULT,25522,5,0,0,5
GREEDY,23197,12,1,1,14
DEFAULT,75226,7,0,0,7
GREEDY,44675,7,1,0,8
GREEDY,20477,9,0,0,9
GREEDY,20074,12,0,1,13
GREEDY,15222,5,1,2,8
GREEDY,31325,7,1,2,10
GREEDY,19988,9,0,0,9
GREEDY,36219,8,0,1,9
GREEDY,18173,9,0,1,10
GREEDY,13872,9,0,0,9
GREEDY,20313,9,0,0,9
GREEDY,31482,9,1,1,11
DEFAULT,50817,7,1,0,8
GREEDY,14351,11,0,2,13
DEFAULT,54868,5,0,2,7
GREEDY,19379,7,1,1,9
GREEDY,22654,9,0,1,10
STATION_GUY,53357,3,0,1,4
GREEDY,39672,9,0,2,11
GREEDY,19966,4,1,2,7
GREEDY,28514,13,0,0,13
DEFAULT,23433,7,0,0,7
GREEDY,15877,9,1,0,10
GREEDY,20835,9,0,2,11
GREEDY,21650,10,0,0,10
GREEDY,23944,5,1,1,7
GREEDY,57700,11,0,1,12
GREEDY,19899,10,0,0,10
STATION_GUY,30834,8,1,1,10
UTILITY_GUY,42099,6,0,0,6
STATION_GUY,64621,5,0,2,7
UTILITY_GUY,80236,8,1,0,9
UTILITY_GUY,35045,5,2,1,8
DEFAULT,36637,5,0,0,5
GREEDY,20176,8,2,2,12
GREEDY,25816,10,0,1,11
DEFAULT,25384,5,1,0,6
DEFAULT,40050,6,0,1,7
STATION_GUY,26124,4,0,2,6
DEFAULT,20719,7,0,0,7
GREEDY,14017,4,1,0,5
GREEDY,33982,8,1,0,9
GREEDY,23521,11,0,0,11
STATION_GUY,37793,5,0,2,7
GREEDY,91637,8,1,0,9
STATION_GUY,48874,5,0,1,6
UTILITY_GUY,58551,5,1,0,6
GREEDY,47029,10,0,2,12
STATION_GUY,30156,4,0,4,8
GREEDY,17357,7,0,1,8
GREEDY,18703,10,0,1,11
STATION_GUY,60275,7,0,1,8
GREEDY,19727,9,1,1,11
GREEDY,35423,9,1,0,10
DEFAULT,54550,6,0,0,6
GREEDY,40332,9,0,2,11
DEFAULT,20325,7,1,0,8
STATION_GUY,17581,6,0,3,9
GREEDY,18118,5,0,2,7
GREEDY,66367,8,0,2,10
UTILITY_GUY,59801,5,1,0,6
STATION_GUY,50653,2,1,4,7
GREEDY,32318,8,0,1,9
DEFAULT,38469,5,0,0,5
GREEDY,29073,11,2,1,14
DEFAULT,31288,8,1,1,10
STATION_GUY,37399,6,1,1,8
DEFAULT,37421,6,0,1,7
GREEDY,22505,6,1,1,8
GREEDY,15315,6,0,1,7
STATION_GUY,41684,6,1,2,9
GREEDY,16283,8,1,2,11
GREEDY,19437,10,0,2,12
GREEDY,18466,11,2,1,14
DEFAULT,45977,6,0,0,6
GREEDY,24774,9,1,0,10
DEFAULT,60836,5,1,0,6
UTILITY_GUY,40901,6,1,0,7
DEFAULT,31472,7,2,0,9
GREEDY,19442,10,2,1,13
GREEDY,16040,9,1,1,11
GREEDY,24969,9,1,1,11
STATION_GUY,53871,7,1,0,8
STATION_GUY,30548,7,0,3,10
UTILITY_GUY,58218,3,0,2,5
DEFAULT,60568,4,1,0,5
DEFAULT,58618,5,1,1,7
GREEDY,18364,9,1,1,11
GREEDY,23475,11,0,2,13
GREEDY,23274,7,0,0,7
DEFAULT,46991,6,0,1,7
UTILITY_GUY,13479,7,1,0,8
GREEDY,21838,8,0,2,10
GREEDY,29167,9,0,2,11
DEFAULT,74292,7,1,2,10
GREEDY,12230,8,0,1,9
STATION_GUY,66266,4,0,0,4
UTILITY_GUY,40432,8,1,1,10
GREEDY,26536,6,1,1,8
GREEDY,27209,8,0,1,9
UTILITY_GUY,41425,7,0,0,7
GREEDY,40162,11,0,1,12
GREEDY,14667,8,0,2,10
GREEDY,17231,11,0,3,14
UTILITY_GUY,44253,2,1,2,5
GREEDY,15311,7,2,1,10
UTILITY_GUY,25658,5,0,1,6
GREEDY,11448,11,0,0,11
DEFAULT,48614,6,1,1,8
GREEDY,36482,9,1,2,12
GREEDY,23091,6,2,1,9
UTILITY_GUY,39943,3,0,0,3
STINGY,69809,3,0,0,3
DEFAULT,57930,5,0,1,6
GREEDY,50180,6,0,2,8
GREEDY,21904,5,1,1,7
UTILITY_GUY,93855,7,1,0,8
DEFAULT,14477,6,0,0,6
GREEDY,20398,6,1,2,9
GREEDY,18635,10,1,2,13
DEFAULT,34638,6,0,0,6
GREEDY,31678,7,0,2,9
GREEDY,39802,10,1,1,12
GREEDY,53789,9,0,1,10
GREEDY,44484,8,0,0,8
STATION_GUY,47143,5,0,3,8
GREEDY,89398,11,0,0,11
GREEDY,24964,11,0,1,12
GREEDY,46834,9,0,3,12
DEFAULT,47135,5,0,1,6
DEFAULT,51400,9,0,0,9
GREEDY,15908,7,0,0,7
GREEDY,20109,7,1,2,10
GREEDY,20928,10,0,0,10
STATION_GUY,64185,5,0,0,5
UTILITY_GUY,61965,5,0,1,6
GREEDY,23765,7,2,0,9
STATION_GUY,14994,6,0,1,7
GREEDY,23865,9,0,1,10
GREEDY,29391,8,1,1,10
GREEDY,24904,7,1,1,9
GREEDY,32643,6,1,1,8
STATION_GUY,66937,7,2,2,11
GREEDY,10529,13,1,0,14
GREEDY,31988,9,0,0,9
UTILITY_GUY,93160,7,2,1,10
UTILITY_GUY,49535,7,2,0,9
DEFAULT,30298,8,2,0,10
GREEDY,25656,10,1,1,12
GREEDY,15970,7,1,2,10
STATION_GUY,55693,6,0,2,8
GREEDY,21357,12,1,1,14
STATION_GUY,8446,4,0,4,8
DEFAULT,76943,4,0,1,5
GREEDY,62638,8,0,0,8
UTILITY_GUY,48397,4,1,0,5
UTILITY_GUY,44978,6,0,1,7
GREEDY,16964,13,1,1,15
STATION_GUY,23825,4,1,2,7
GREEDY,17866,6,1,1,8
GREEDY,13854,10,1,0,11
GREEDY,27390,10,0,0,10
GREEDY,23349,10,0,1,11
GREEDY,34045,11,1,1,13
UTILITY_GUY,53539,7,0,1,8
STATION_GUY,39305,8,0,1,9
UTILITY_GUY,82957,5,1,0,6
STATION_GUY,27247,7,0,0,7
GREEDY,18440,8,2,0,10
GREEDY,39639,8,0,1,9
GREEDY,19366,7,0,2,9
GREEDY,21476,8,0,2,10
DEFAULT,44396,4,0,0,4
DEFAULT,43499,6,0,0,6
DEFAULT,67705,3,0,4,7
UTILITY_GUY,33838,6,0,1,7
UTILITY_GUY,43290,6,0,0,6
DEFAULT,18388,5,0,2,7
GREEDY,20312,10,1,0,11
GREEDY,13152,9,0,1,10
GREEDY,21112,8,0,2,10
GREEDY,13672,9,0,2,11
STINGY,82025,5,0,0,5
DEFAULT,44425,6,0,0,6
GREEDY,23180,9,0,1,10
DEFAULT,30517,9,1,0,10
GREEDY,30596,13,0,2,15
GREEDY,19377,14,0,1,15
DEFAULT,66247,7,0,0,7
GREEDY,22450,10,0,1,11
UTILITY_GUY,25325,7,2,0,9
GREEDY,29077,8,0,2,10
GREEDY,11781,6,0,1,7
GREEDY,20330,9,0,1,10
DEFAULT,61260,5,1,0,6
STATION_GUY,6958,3,0,4,7
GREEDY,21924,9,0,2,11
GREEDY,30503,9,0,2,11
GREEDY,83077,10,1,2,13
GREEDY,22736,7,1,0,8
GREEDY,17321,10,1,1,12
DEFAULT,49113,9,1,1,11
GREEDY,21532,7,0,1,8
GREEDY,22159,9,0,1,10
STINGY,83415,4,0,0,4
GREEDY,17802,9,1,2,12
DEFAULT,69681,9,0,0,9
STATION_GUY,64431,6,0,2,8
DEFAULT,68699,6,0,0,6
GREEDY,22127,9,0,0,9
DEFAULT,40833,7,1,1,9
DEFAULT,34191,7,0,1,8
GREEDY,32733,7,0,1,8
UTILITY_GUY,29828,5,1,0,6
GREEDY,12341,8,0,2,10
GREEDY,12662,11,0,2,13
GREEDY,23598,11,1,1,13
STATION_GUY,47504,7,0,1,8
GREEDY,35472,8,0,1,9
GREEDY,19087,11,1,2,14
GREEDY,36027,8,1,1,10
STATION_GUY,13601,8,0,4,12
DEFAULT,45195,6,0,0,6
GREEDY,23445,12,0,0,12
GREEDY,19664,9,2,1,12
DEFAULT,46657,6,1,0,7
STATION_GUY,42125,6,1,1,8
GREEDY,29130,9,1,2,12
GREEDY,26951,10,1,1,12
GREEDY,70009,6,1,2,9
STATION_GUY,40621,5,2,2,9
STINGY,62995,2,0,0,2
STATION_GUY,50366,7,0,1,8
DEFAULT,84657,6,0,1,7
GREEDY,28868,10,1,2,13
STATION_GUY,24354,6,0,2,8
DEFAULT,65934,4,0,0,4
GREEDY,11958,7,0,1,8
GREEDY,40642,7,0,2,9
GREEDY,21022,11,0,1,12
DEFAULT,26824,4,0,0,4
GREEDY,36812,9,1,2,12
UTILITY_GUY,66128,6,0,0,6
DEFAULT,91417,9,0,0,9
DEFAULT,48671,5,0,3,8
GREEDY,77067,9,0,2,11
GREEDY,19521,5,0,1,6
DEFAULT,51438,8,0,0,8
GREEDY,16273,9,0,1,10
GREEDY,50704,9,1,2,12
STATION_GUY,35823,5,0,1,6
GREEDY,30736,10,0,1,11
GREEDY,30468,7,0,1,8
STATION_GUY,56313,8,0,1,9
GREEDY,86960,9,0,0,9
GREEDY,18301,10,1,2,13
GREEDY,17524,11,1,0,12
DEFAULT,16459,2,1,1,4
GREEDY,25282,12,2,0,14
GREEDY,26199,8,0,1,9
DEFAULT,40730,9,0,1,10
UTILITY_GUY,32583,10,0,1,11
GREEDY,14208,6,1,1,8
STATION_GUY,34994,4,1,2,7
STATION_GUY,72070,6,0,1,7
DEFAULT,36174,5,0,2,7
GREEDY,13782,9,1,0,10
GREEDY,18413,6,0,2,8
UTILITY_GUY,11053,5,0,1,6
DEFAULT,83640,9,1,1,11
DEFAULT,46699,7,0,0,7
GREEDY,22350,6,0,1,7
STATION_GUY,23122,4,0,2,6
GREEDY,19866,8,0,1,9
DEFAULT,82305,9,0,0,9
GREEDY,40037,10,1,1,12
GREEDY,55636,9,0,1,10
STATION_GUY,22802,6,0,1,7
GREEDY,18031,8,0,1,9
GREEDY,74346,8,1,1,10
STATION_GUY,30424,7,0,2,9
GREEDY,15188,8,1,1,10
UTILITY_GUY,40973,4,1,0,5
STATION_GUY,40325,7,0,1,8
DEFAULT,24888,7,0,2,9
DEFAULT,39886,9,0,1,10
DEFAULT,38931,8,0,0,8
DEFAULT,99122,8,1,1,10
STATION_GUY,41172,7,0,0,7
DEFAULT,35720,7,0,0,7
GREEDY,13156,11,0,1,12
GREEDY,21606,9,1,2,12
UTILITY_GUY,43850,6,1,0,7
STATION_GUY,16777,3,0,4,7
GREEDY,17792,9,0,0,9
STATION_GUY,23347,3,0,4,7
UTILITY_GUY,90563,8,1,1,10
UTILITY_GUY,99019,7,0,0,7
STATION_GUY,35087,9,0,0,9
GREEDY,10961,5,0,1,6
GREEDY,31107,11,1,0,12
STATION_GUY,75581,5,0,1,6
GREEDY,13409,6,0,2,8
GREEDY,24500,12,0,1,13
DEFAULT,86075,10,0,1,11
DEFAULT,47152,5,0,1,6
GREEDY,39711,6,1,1,8
UTILITY_GUY,44429,4,0,0,4
STATION_GUY,17609,1,1,4,6
STATION_GUY,20666,6,0,1,7
GREEDY,14994,6,1,2,9
GREEDY,48269,9,0,1,10
GREEDY,16334,8,1,3,12
GREEDY,21553,11,1,1,13
STATION_GUY,29787,4,1,2,7
UTILITY_GUY,20710,6,2,0,8
DEFAULT,47795,7,0,1,8
UTILITY_GUY,36783,6,0,1,7
GREEDY,28156,7,0,1,8
GREEDY,35311,9,0,0,9
DEFAULT,72190,7,0,0,7
STATION_GUY,80499,4,0,0,4
GREEDY,28522,10,0,1,11
GREEDY,18604,7,0,1,8
DEFAULT,43059,5,1,0,6
GREEDY,15029,6,1,0,7
DEFAULT,44503,7,0,1,8
GREEDY,18581,10,0,0,10
UTILITY_GUY,55609,6,0,0,6
GREEDY,26269,9,0,1,10
STATION_GUY,56387,3,0,2,5
STATION_GUY,69412,4,1,1,6
GREEDY,17753,3,0,0,3
STATION_GUY,45146,3,0,1,4
GREEDY,16365,9,0,0,9
DEFAULT,30803,6,0,1,7
GREEDY,32029,11,1,0,12
GREEDY,50209,10,0,2,12
GREEDY,33652,8,0,2,10
GREEDY,15932,10,1,1,12
DEFAULT,41384,7,0,1,8
DEFAULT,51815,7,0,3,10
STATION_GUY,58142,6,1,2,9
DEFAULT,65499,8,0,0,8
DEFAULT,56371,10,0,0,10
DEFAULT,73383,7,0,0,7
GREEDY,20534,8,1,1,10
STATION_GUY,14391,5,1,4,10
STINGY,76556,4,0,1,5
UTILITY_GUY,32911,7,0,0,7
GREEDY,21401,7,1,1,9
STINGY,94694,2,0,1,3
DEFAULT,78313,12,0,0,12
DEFAULT,25364,9,0,0,9
GREEDY,33991,9,0,1,10
UTILITY_GUY,45533,7,0,0,7
DEFAULT,75388,8,0,0,8
DEFAULT,22533,4,2,0,6
DEFAULT,38576,8,1,0,9
DEFAULT,33982,4,0,1,5
STATION_GUY,31280,3,2,2,7
DEFAULT,36147,8,0,1,9
GREEDY,51021,8,0,4,12
GREEDY,34042,8,1,1,10
GREEDY,20696,6,1,0,7
GREEDY,15906,10,0,0,10
GREEDY,19158,8,0,0,8
DEFAULT,32476,3,0,3,6
GREEDY,21164,9,0,1,10
DEFAULT,42113,7,0,2,9
GREEDY,94168,11,0,1,12
GREEDY,21657,8,1,1,10
STATION_GUY,51268,6,1,0,7
GREEDY,21452,9,1,1,11
GREEDY,24622,9,1,2,12
STINGY,90036,2,0,0,2
DEFAULT,37276,7,1,0,8
DEFAULT,35472,4,0,0,4
GREEDY,70341,14,0,1,15
DEFAULT,44950,6,0,1,7
STATION_GUY,21722,5,0,1,6
GREEDY,26411,8,1,2,11
DEFAULT,12931,6,0,0,6
DEFAULT,32259,6,0,1,7
GREEDY,39042,9,0,0,9
GREEDY,45957,6,1,2,9
GREEDY,32848,9,0,1,10
GREEDY,10831,7,0,3,10
GREEDY,17666,4,0,2,6
STINGY,36187,4,0,1,5
GREEDY,29055,8,0,1,9
GREEDY,28163,6,0,2,8
DEFAULT,20946,5,0,0,5
GREEDY,26779,8,0,0,8
UTILITY_GUY,28151,5,0,1,6
STATION_GUY,50820,8,0,1,9
GREEDY,36885,10,0,2,12
DEFAULT,39147,8,0,0,8
GREEDY,21233,7,1,0,8
STATION_GUY,12295,1,1,4,6
GREEDY,24748,6,1,1,8
GREEDY,14878,9,0,0,9
STATION_GUY,24358,7,2,0,9
GREEDY,14954,9,1,2,12
GREEDY,18270,11,0,1,12
GREEDY,77819,8,2,2,12
GREEDY,71846,9,1,0,10
GREEDY,22088,8,1,2,11
GREEDY,13261,9,0,0,9
STATION_GUY,39723,5,0,1,6
STATION_GUY,77444,5,0,1,6
GREEDY,28667,9,1,1,11
GREEDY,22331,10,0,1,11
STATION_GUY,25327,5,1,0,6
STATION_GUY,28899,9,0,1,10
GREEDY,28526,8,2,1,11
STATION_GUY,37535,4,0,1,5
DEFAULT,55042,7,1,0,8
GREEDY,9214,6,0,1,7
GREEDY,21708,8,0,2,10
GREEDY,23233,6,0,0,6
GREEDY,24700,7,0,3,10
GREEDY,15936,7,0,4,11
GREEDY,29540,9,0,2,11
GREEDY,37145,13,0,1,14
GREEDY,80965,10,0,0,10
GREEDY,8615,8,0,1,9
DEFAULT,54826,7,0,0,7
GREEDY,18049,10,1,2,13
DEFAULT,28945,4,1,0,5
DEFAULT,25436,6,0,1,7
STATION_GUY,64505,7,0,1,8
GREEDY,21815,6,0,0,6
DEFAULT,17247,6,0,1,7
DEFAULT,33810,6,0,0,6
GREEDY,12578,10,1,0,11
GREEDY,17769,9,2,1,12
GREEDY,8352,13,0,2,15
UTILITY_GUY,42127,5,1,0,6
GREEDY,18569,10,0,2,12
DEFAULT,21641,7,0,0,7
GREEDY,20197,10,2,1,13
UTILITY_GUY,17188,6,0,2,8
GREEDY,29851,8,0,2,10
GREEDY,14810,9,0,1,10
GREEDY,43992,9,1,0,10
STATION_GUY,25215,6,0,1,7
STATION_GUY,98956,5,0,1,6
GREEDY,14219,10,1,0,11
UTILITY_GUY,36200,5,1,0,6
UTILITY_GUY,31727,6,0,1,7
GREEDY,22604,11,1,1,13
DEFAULT,41293,6,0,0,6
UTILITY_GUY,68668,4,1,1,6
DEFAULT,16622,4,1,2,7
STATION_GUY,26056,4,0,0,4
GREEDY,12440,9,2,2,13
UTILITY_GUY,60712,7,1,1,9
GREEDY,18167,9,0,1,10
STATION_GUY,69673,7,1,4,12
GREEDY,44735,9,0,1,10
GREEDY,25648,10,0,1,11
UTILITY_GUY,22811,5,1,0,6
GREEDY,18889,7,0,0,7
DEFAULT,33366,9,1,0,10
UTILITY_GUY,20949,7,0,0,7
GREEDY,14215,8,1,0,9
STATION_GUY,19540,8,0,1,9
STATION_GUY,70568,7,0,0,7
STATION_GUY,90242,1,0,4,5
DEFAULT,43682,10,0,0,10
UTILITY_GUY,33957,6,1,0,7
DEFAULT,38614,5,1,1,7
DEFAULT,38471,8,0,2,10
GREEDY,20545,10,0,1,11
UTILITY_GUY,71637,7,1,0,8
GREEDY,7339,7,1,2,10
DEFAULT,34615,8,1,1,10
GREEDY,98344,8,1,0,9
STATION_GUY,39983,3,0,1,4
STINGY,94325,3,0,0,3
UTILITY_GUY,52016,5,1,1,7
DEFAULT,58663,5,0,0,5
STATION_GUY,42259,3,0,2,5
GREEDY,28390,9,0,1,10
GREEDY,19419,7,1,1,9
STATION_GUY,50827,6,0,1,7
STATION_GUY,77555,7,0,0,7
UTILITY_GUY,14725,3,1,1,5
DEFAULT,64321,5,1,1,7
GREEDY,14158,12,0,0,12
GREEDY,31091,7,1,1,9
GREEDY,27194,10,1,2,13
GREEDY,90325,10,0,1,11
GREEDY,37875,8,1,1,10
DEFAULT,79397,7,0,0,7
UTILITY_GUY,46354,6,1,2,9
GREEDY,12818,10,1,0,11
GREEDY,25796,9,0,3,12
GREEDY,17613,8,0,0,8
UTILITY_GUY,37015,4,2,2,8
GREEDY,35712,7,2,0,9
GREEDY,62798,11,1,2,14
DEFAULT,24113,6,1,0,7
GREEDY,21414,9,0,0,9
GREEDY,22302,8,0,2,10
GREEDY,48426,8,1,2,11
UTILITY_GUY,36361,3,0,1,4
DEFAULT,29874,5,0,0,5
GREEDY,19402,7,1,0,8
GREEDY,28835,8,0,1,9
DEFAULT,57429,4,0,0,4
UTILITY_GUY,26321,4,0,1,5
GREEDY,17062,10,0,1,11
GREEDY,24919,8,0,0,8
GREEDY,20180,11,1,1,13
GREEDY,33653,8,0,1,9
GREEDY,35292,10,1,1,12
GREEDY,21938,8,0,2,10
DEFAULT,24070,4,0,1,5
GREEDY,10233,9,0,4,13
GREEDY,27021,7,1,0,8
GREEDY,31291,8,0,1,9
DEFAULT,51237,5,0,1,6
DEFAULT,27293,6,0,2,8
GREEDY,27474,9,0,1,10
DEFAULT,46396,5,0,1,6
GREEDY,35698,8,0,1,9
GREEDY,24744,7,1,0,8
DEFAULT,77344,6,1,1,8
STATION_GUY,37144,4,1,2,7
GREEDY,15305,9,1,3,13
GREEDY,13436,9,0,1,10
DEFAULT,32093,4,0,0,4
GREEDY,21965,8,1,1,10
GREEDY,22447,6,1,3,10
DEFAULT,53855,5,1,0,6
STINGY,72946,3,0,0,3
GREEDY,17220,9,1,3,13
DEFAULT,38865,8,1,0,9
GREEDY,36101,10,0,1,11
GREEDY,14294,12,1,1,14
UTILITY_GUY,48753,4,2,0,6
GREEDY,17838,7,0,3,10
GREEDY,29505,5,1,4,10
GREEDY,23076,7,1,1,9
GREEDY,36243,8,0,0,8
GREEDY,20363,7,0,0,7
UTILITY_GUY,31249,7,1,3,11
STATION_GUY,22423,5,1,1,7
DEFAULT,64749,6,1,0,7
UTILITY_GUY,25943,5,0,0,5
GREEDY,15473,8,1,1,10
GREEDY,19355,6,1,3,10
DEFAULT,43973,7,0,1,8
UTILITY_GUY,27790,2,0,0,2
GREEDY,27215,9,1,1,11
UTILITY_GUY,30754,5,0,0,5
GREEDY,28954,12,0,3,15
STATION_GUY,50331,5,0,2,7
GREEDY,15820,8,0,0,8
UTILITY_GUY,65516,7,0,1,8
GREEDY,28115,9,0,1,10
STATION_GUY,38096,5,0,2,7
GREEDY,13742,9,0,1,10
DEFAULT,32272,8,1,0,9
DEFAULT,34836,4,0,1,5
GREEDY,19353,8,0,1,9
GREEDY,22509,5,1,0,6
DEFAULT,24908,5,0,4,9
UTILITY_GUY,33000,7,2,1,10
GREEDY,23926,8,0,0,8
DEFAULT,41136,7,1,0,8
GREEDY,12696,6,0,2,8
GREEDY,59222,10,1,0,11
UTILITY_GUY,33301,4,1,2,7
STATION_GUY,27368,5,0,1,6
STATION_GUY,40640,7,1,1,9
DEFAULT,22224,3,0,3,6
STATION_GUY,74796,5,0,1,6
DEFAULT,57472,11,0,0,11
GREEDY,43240,12,0,1,13
UTILITY_GUY,54733,6,1,0,7
GREEDY,21528,9,0,1,10
UTILITY_GUY,43956,7,1,0,8
GREEDY,50553,9,1,0,10
STATION_GUY,34083,6,0,3,9
GREEDY,92444,9,0,1,10
GREEDY,15327,8,1,1,10
GREEDY,16851,10,0,2,12
STATION_GUY,98727,7,0,3,10
GREEDY,20987,4,1,0,5
GREEDY,23214,9,0,1,10
GREEDY,25881,7,1,2,10
GREEDY,40906,8,0,2,10
STATION_GUY,55037,4,0,2,6
GREEDY,24195,7,0,1,8
DEFAULT,62622,7,0,1,8
STATION_GUY,27775,6,0,1,7
GREEDY,24877,8,0,1,9
GREEDY,21306,9,1,1,11
GREEDY,28885,9,1,4,14
GREEDY,14136,10,0,3,13
DEFAULT,30849,5,0,0,5
GREEDY,11035,6,0,0,6
DEFAULT,72065,9,0,0,9
GREEDY,21999,5,1,1,7
GREEDY,24454,7,1,0,8
UTILITY_GUY,37836,5,1,0,6
UTILITY_GUY,46330,6,1,0,7
STATION_GUY,45849,3,0,4,7
GREEDY,35868,11,0,2,13
DEFAULT,22857,8,0,0,8
GREEDY,16012,5,0,0,5
GREEDY,12647,9,0,1,10
GREEDY,18488,9,1,0,10
GREEDY,12308,11,0,1,12
GREEDY,26215,9,0,2,11
GREEDY,17004,9,0,1,10
GREEDY,14960,9,1,0,10
GREEDY,97777,11,1,0,12
UTILITY_GUY,36559,6,0,0,6
GREEDY,19120,8,1,0,9
DEFAULT,42882,7,1,2,10
GREEDY,14944,6,1,0,7
STATION_GUY,46059,4,0,2,6
UTILITY_GUY,10489,6,1,2,9
DEFAULT,37833,5,0,0,5
STATION_GUY,50365,4,1,1,6
GREEDY,86245,8,0,2,10
GREEDY,16978,8,0,3,11
DEFAULT,25970,7,0,0,7
GREEDY,27100,8,0,1,9
GREEDY,26934,7,1,2,10
GREEDY,27709,7,0,1,8
GREEDY,37167,6,0,0,6
GREEDY,15705,13,1,2,16
STATION_GUY,29878,5,0,1,6
STATION_GUY,33811,6,0,3,9
GREEDY,11248,10,1,0,11
GREEDY,31799,8,1,1,10
GREEDY,52935,10,2,0,12
STATION_GUY,23947,6,0,0,6
GREEDY,31699,9,0,1,10
GREEDY,27459,8,1,2,11
DEFAULT,49989,7,0,0,7
UTILITY_GUY,59988,7,1,2,10
GREEDY,18653,10,0,2,12
GREEDY,25709,7,0,2,9
STATION_GUY,68533,8,1,0,9
DEFAULT,54904,6,1,1,8
DEFAULT,31296,6,0,1,7
GREEDY,37939,6,0,1,7
STINGY,55728,3,0,1,4
UTILITY_GUY,21127,4,1,0,5
DEFAULT,57032,7,0,1,8
GREEDY,38182,10,0,0,10
GREEDY,22345,9,0,2,11
STATION_GUY,56543,6,0,1,7
GREEDY,22935,9,0,1,10
GREEDY,18410,10,2,1,13
GREEDY,34734,8,0,2,10
DEFAULT,46066,5,0,1,6
STATION_GUY,9507,4,1,2,7
DEFAULT,57124,5,0,1,6
UTILITY_GUY,17986,6,0,0,6
UTILITY_GUY,17666,6,1,1,8
DEFAULT,58943,6,0,0,6
GREEDY,12111,10,1,1,12
GREEDY,39216,7,0,2,9
GREEDY,11289,8,0,2,10
GREEDY,41605,11,0,0,11
GREEDY,24586,7,1,1,9
UTILITY_GUY,67932,8,2,0,10
GREEDY,68456,8,2,2,12
DEFAULT,57532,3,0,2,5
DEFAULT,30450,8,0,2,10
GREEDY,98015,10,0,2,12
STATION_GUY,13469,6,0,4,10
GREEDY,29988,8,0,0,8
UTILITY_GUY,17286,8,0,1,9
DEFAULT,27078,5,0,1,6
GREEDY,21891,9,0,2,11
STATION_GUY,53577,10,1,2,13
DEFAULT,52233,7,0,1,8
DEFAULT,48631,7,1,1,9
GREEDY,32222,6,0,1,7
DEFAULT,59767,7,0,1,8
UTILITY_GUY,47818,5,0,1,6
DEFAULT,48000,7,0,0,7
GREEDY,88964,10,0,0,10
STATION_GUY,50500,7,0,0,7
STATION_GUY,44576,8,0,1,9
STATION_GUY,80463,7,0,0,7
STATION_GUY,32207,5,0,0,5
GREEDY,38023,9,0,1,10
GREEDY,15200,10,0,0,10
GREEDY,17766,9,0,0,9
GREEDY,24985,6,0,0,6
GREEDY,30504,7,0,0,7
GREEDY,49744,9,0,1,10
UTILITY_GUY,33188,3,1,0,4
DEFAULT,88084,6,1,1,8
UTILITY_GUY,53695,5,0,0,5
GREEDY,12782,7,0,3,10
DEFAULT,47554,5,0,0,5
GREEDY,38086,10,2,2,14
GREEDY,21073,8,1,1,10
GREEDY,34607,9,0,1,10
GREEDY,26839,11,0,2,13
GREEDY,8773,11,0,0,11
GREEDY,21312,9,0,2,11
STATION_GUY,82766,6,0,0,6
GREEDY,23706,7,0,1,8
GREEDY,14189,9,1,0,10
GREEDY,54922,12,1,1,14
GREEDY,34465,9,0,1,10
STATION_GUY,29775,6,0,0,6
GREEDY,20152,8,0,1,9
DEFAULT,86060,9,0,0,9
DEFAULT,26468,9,1,1,11
GREEDY,20883,8,0,2,10
DEFAULT,70250,6,0,0,6
DEFAULT,31220,10,1,0,11
UTILITY_GUY,43491,3,1,1,5
GREEDY,34475,6,0,1,7
GREEDY,13192,10,0,0,10
GREEDY,19451,9,0,1,10
GREEDY,18479,10,1,1,12
GREEDY,28023,9,1,2,12
GREEDY,15568,7,0,0,7
GREEDY,80307,9,0,2,11
DEFAULT,71122,7,0,1,8
GREEDY,29313,10,0,0,10
DEFAULT,52093,5,0,2,7
DEFAULT,35079,4,1,1,6
DEFAULT,39382,6,0,0,6
GREEDY,16861,7,0,0,7
GREEDY,23862,8,0,2,10
DEFAULT,51482,6,0,1,7
UTILITY_GUY,32737,7,2,1,10
GREEDY,11062,8,1,0,9
GREEDY,9193,8,1,0,9
UTILITY_GUY,59287,7,0,1,8
DEFAULT,21281,8,0,1,9
STATION_GUY,32832,5,0,1,6
STATION_GUY,18331,5,1,0,6
GREEDY,29687,11,0,0,11
STATION_GUY,18341,5,1,4,10
UTILITY_GUY,24735,4,0,0,4
GREEDY,14676,6,1,1,8
UTILITY_GUY,48352,5,1,2,8
GREEDY,33000,10,1,0,11
GREEDY,21212,9,0,1,10
GREEDY,23288,7,0,3,10
GREEDY,32019,8,1,0,9
STATION_GUY,85169,5,0,1,6
GREEDY,15598,6,0,2,8
STATION_GUY,34858,7,0,1,8
DEFAULT,40920,5,0,1,6
DEFAULT,72101,9,0,0,9
GREEDY,17530,12,1,0,13
GREEDY,25213,10,0,3,13
DEFAULT,33379,10,0,0,10
GREEDY,23481,9,0,0,9
UTILITY_GUY,26038,5,1,1,7
DEFAULT,9216,5,1,4,10
UTILITY_GUY,67087,4,0,1,5
STATION_GUY,51187,4,0,2,6
DEFAULT,79626,8,0,2,10
GREEDY,45861,6,0,2,8
DEFAULT,29127,6,0,2,8
GREEDY,29566,10,0,0,10
GREEDY,22420,8,0,0,8
UTILITY_GUY,58611,7,1,0,8
GREEDY,33182,7,1,0,8
STATION_GUY,16222,4,0,4,8
DEFAULT,30598,7,0,1,8
GREEDY,21111,8,0,0,8
GREEDY,19408,7,1,1,9
GREEDY,10546,7,0,1,8
STATION_GUY,32172,3,0,4,7
GREEDY,28927,7,1,0,8
GREEDY,59859,10,0,1,11
DEFAULT,68288,6,0,0,6
GREEDY,15353,7,0,1,8
GREEDY,23099,7,1,2,10
DEFAULT,31802,5,0,1,6
UTILITY_GUY,47683,7,1,1,9
UTILITY_GUY,94470,5,1,1,7
UTILITY_GUY,68999,7,0,0,7
GREEDY,13188,11,1,0,12
GREEDY,20709,7,0,2,9
GREEDY,14439,7,1,3,11
GREEDY,68682,8,1,1,10
STATION_GUY,22951,6,1,0,7
GREEDY,16839,7,1,3,11
GREEDY,29588,8,0,2,10
GREEDY,30855,7,1,1,9
DEFAULT,53701,5,0,1,6
GREEDY,20407,5,0,0,5
GREEDY,40311,9,0,2,11
DEFAULT,41083,7,0,1,8
STINGY,58615,5,0,0,5
GREEDY,19075,8,0,1,9
DEFAULT,26420,8,1,0,9
STINGY,34710,4,0,1,5
GREEDY,17509,6,1,2,9
GREEDY,28944,8,0,2,10
DEFAULT,68452,9,1,1,11
DEFAULT,36424,8,1,0,9
GREEDY,24651,9,0,1,10
DEFAULT,38197,2,0,1,3
GREEDY,18772,10,1,1,12
GREEDY,19148,7,0,1,8
GREEDY,19792,7,0,0,7
STATION_GUY,51915,7,0,2,9
GREEDY,15640,11,1,0,12
GREEDY,21035,9,2,3,14
DEFAULT,14108,6,0,0,6
GREEDY,19593,7,1,1,9
GREEDY,22977,10,0,1,11
DEFAULT,73107,8,0,1,9
GREEDY,18660,7,0,2,9
GREEDY,13373,9,0,2,11
DEFAULT,57057,7,0,0,7
STATION_GUY,15987,4,1,1,6
UTILITY_GUY,45049,6,0,1,7
GREEDY,11029,6,0,1,7
GREEDY,20023,8,1,2,11
STATION_GUY,27805,6,0,0,6
STATION_GUY,27911,5,0,4,9
GREEDY,10525,9,0,0,9
GREEDY,36879,13,1,1,15
GREEDY,23320,10,2,3,15
GREEDY,72790,9,0,1,10
STATION_GUY,53423,4,0,1,5
GREEDY,29346,7,0,2,9
STATION_GUY,29776,8,0,2,10
UTILITY_GUY,24366,4,1,0,5
GREEDY,16635,10,0,1,11
GREEDY,20391,10,0,0,10
GREEDY,20613,8,1,1,10
STATION_GUY,31240,7,1,2,10
DEFAULT,22118,6,0,0,6
UTILITY_GUY,60677,7,0,0,7
GREEDY,9741,8,0,0,8
UTILITY_GUY,78091,6,0,0,6
GREEDY,42294,9,1,0,10
STATION_GUY,34673,6,0,1,7
UTILITY_GUY,36146,4,1,0,5
UTILITY_GUY,20593,6,0,0,6
GREEDY,19413,7,0,1,8
DEFAULT,30901,5,0,0,5
GREEDY,38443,8,0,2,10
DEFAULT,14250,8,0,1,9
DEFAULT,87511,6,1,1,8
DEFAULT,57926,6,0,2,8
GREEDY,19457,10,0,1,11
DEFAULT,54791,4,0,0,4
DEFAULT,30685,8,1,0,9
GREEDY,27368,9,0,2,11
GREEDY,26800,7,0,1,8
STINGY,80603,5,0,0,5
GREEDY,18400,8,1,2,11
DEFAULT,87446,9,0,1,10
GREEDY,28559,11,0,0,11
DEFAULT,32226,6,0,1,7
GREEDY,18893,8,1,3,12
DEFAULT,49960,9,1,1,11
GREEDY,30062,9,1,1,11
GREEDY,16311,8,1,1,10
GREEDY,24526,9,1,1,11
UTILITY_GUY,26906,7,0,0,7
UTILITY_GUY,38758,5,0,0,5
DEFAULT,93459,8,1,1,10
GREEDY,49703,9,0,2,11
GREEDY,15967,9,0,2,11
UTILITY_GUY,30045,4,1,0,5
GREEDY,33370,6,1,4,11
GREEDY,13272,10,0,1,11
STATION_GUY,24836,4,0,1,5
GREEDY,33152,11,1,1,13
DEFAULT,59784,10,0,1,11
GREEDY,19726,5,2,2,9
GREEDY,17546,9,0,0,9
UTILITY_GUY,11953,4,0,0,4
STATION_GUY,53374,8,1,1,10
GREEDY,27537,7,1,1,9
GREEDY,12801,7,0,1,8
STATION_GUY,25953,4,2,0,6
GREEDY,20633,11,0,1,12
GREEDY,17767,9,0,2,11
STATION_GUY,46852,5,0,3,8
GREEDY,26403,10,0,2,12
UTILITY_GUY,35920,5,2,0,7
GREEDY,19389,10,0,1,11
GREEDY,24303,11,0,1,12
GREEDY,11761,7,2,1,10
GREEDY,42879,8,2,1,11
GREEDY,14783,8,2,1,11
GREEDY,23168,9,0,1,10
GREEDY,21693,7,2,1,10
GREEDY,19524,7,2,2,11
GREEDY,23469,8,1,0,9
GREEDY,21605,11,0,3,14
GREEDY,15245,7,0,1,8
DEFAULT,23464,6,0,0,6
GREEDY,25868,7,1,1,9
STATION_GUY,42352,6,0,0,6
GREEDY,43559,9,1,0,10
GREEDY,33154,6,1,1,8
GREEDY,60149,9,0,1,10
GREEDY,27772,11,0,1,12
DEFAULT,37968,7,0,0,7
STATION_GUY,45671,5,1,1,7
GREEDY,19270,8,1,3,12
STATION_GUY,36952,6,0,3,9
GREEDY,10326,10,1,0,11
STATION_GUY,24272,4,0,4,8
GREEDY,29653,7,1,2,10
STATION_GUY,12247,3,0,1,4
GREEDY,40266,11,0,1,12
DEFAULT,35185,5,0,1,6
GREEDY,34194,9,0,1,10
GREEDY,38288,8,0,1,9
DEFAULT,40538,8,0,1,9
GREEDY,25145,9,0,2,11
GREEDY,33463,8,1,0,9
UTILITY_GUY,35475,5,0,1,6
STATION_GUY,37467,4,1,2,7
GREEDY,20332,4,0,1,5
STATION_GUY,79387,3,0,1,4
GREEDY,16015,9,2,1,12
STATION_GUY,44755,5,0,1,6
GREEDY,30094,10,0,0,10
UTILITY_GUY,34132,9,1,0,10
STATION_GUY,57980,4,0,0,4
GREEDY,34040,10,0,1,11
GREEDY,22878,9,0,1,10
UTILITY_GUY,41205,6,1,2,9
UTILITY_GUY,59191,6,1,1,8
GREEDY,13950,11,0,0,11
STINGY,87597,3,0,0,3
UTILITY_GUY,62990,3,0,1,4
DEFAULT,76093,5,0,0,5
GREEDY,15673,11,0,0,11
DEFAULT,46215,8,0,2,10
UTILITY_GUY,17971,5,0,0,5
STATION_GUY,94854,6,0,1,7
GREEDY,31658,10,1,2,13
GREEDY,38848,9,0,3,12
GREEDY,26093,7,0,2,9
GREEDY,20620,9,2,3,14
GREEDY,16618,7,0,1,8
GREEDY,20136,9,0,2,11
DEFAULT,28805,4,1,1,6
GREEDY,22343,6,1,2,9
STATION_GUY,51391,9,0,2,11
GREEDY,28958,4,1,2,7
GREEDY,24007,8,1,2,11
DEFAULT,22763,6,0,1,7
DEFAULT,36543,4,1,1,6
GREEDY,21826,8,0,1,9
GREEDY,31477,8,0,1,9
GREEDY,12790,6,1,0,7
UTILITY_GUY,99031,6,0,1,7
GREEDY,23623,8,1,2,11
GREEDY,28024,9,0,0,9
GREEDY,15936,9,1,2,12
GREEDY,22547,10,0,1,11
STATION_GUY,36500,8,0,0,8
GREEDY,15494,10,0,0,10
GREEDY,48657,9,1,2,12
GREEDY,24899,8,0,0,8
STATION_GUY,16467,6,0,1,7
GREEDY,25879,8,1,0,9
STATION_GUY,29691,5,0,1,6
UTILITY_GUY,72132,7,1,0,8
STATION_GUY,33050,3,1,1,5
UTILITY_GUY,39636,5,0,1,6
UTILITY_GUY,39866,4,0,0,4
GREEDY,62558,9,0,1,10
DEFAULT,34338,7,0,0,7
GREEDY,19033,11,0,1,12
GREEDY,24027,11,0,1,12
STATION_GUY,46061,6,0,1,7
GREEDY,22594,11,2,2,15
GREEDY,20607,9,0,0,9
GREEDY,19748,11,0,1,12
GREEDY,27486,10,0,2,12
GREEDY,13258,8,1,2,11
GREEDY,18982,8,0,0,8
GREEDY,31148,9,0,2,11
GREEDY,14027,14,1,0,15
DEFAULT,38883,7,1,0,8
DEFAULT,43274,8,0,1,9
GREEDY,13886,7,2,1,10
DEFAULT,32358,8,0,0,8
UTILITY_GUY,38762,4,1,0,5
GREEDY,16093,8,0,1,9
STATION_GUY,21333,4,0,3,7
GREEDY,54471,10,0,1,11
GREEDY,13127,9,2,0,11
STATION_GUY,17164,2,0,4,6
GREEDY,23260,11,0,1,12
GREEDY,30397,9,0,1,10
GREEDY,23790,8,1,0,9
DEFAULT,59886,5,0,1,6
UTILITY_GUY,31836,6,0,1,7
UTILITY_GUY,39734,5,1,0,6
STATION_GUY,44540,6,0,0,6
GREEDY,44039,9,0,3,12
GREEDY,18615,10,0,1,11
UTILITY_GUY,53131,5,1,0,6
GREEDY,18240,11,0,0,11
DEFAULT,35112,5,0,1,6
GREEDY,27116,8,1,0,9
DEFAULT,86492,9,1,0,10
GREEDY,15660,10,0,1,11
GREEDY,39516,6,1,0,7
GREEDY,11912,7,0,1,8
GREEDY,12806,9,0,1,10
GREEDY,17534,10,1,0,11
GREEDY,28105,7,1,1,9
GREEDY,15149,8,1,1,10
GREEDY,30362,9,0,2,11
UTILITY_GUY,44054,8,0,0,8
GREEDY,16707,7,0,0,7
DEFAULT,22984,5,0,1,6
GREEDY,13472,5,1,1,7
GREEDY,11119,10,0,1,11
UTILITY_GUY,40764,4,0,2,6
UTILITY_GUY,40662,6,0,1,7
GREEDY,10652,8,0,3,11
GREEDY,14046,11,0,1,12
UTILITY_GUY,20840,7,1,0,8
STATION_GUY,60734,7,0,2,9
GREEDY,30608,6,0,1,7
DEFAULT,35630,6,0,0,6
GREEDY,20402,6,0,1,7
STATION_GUY,39423,5,0,2,7
GREEDY,23305,6,1,1,8
STATION_GUY,21556,6,0,2,8
GREEDY,13946,5,1,2,8
UTILITY_GUY,68661,8,0,0,8
GREEDY,38338,10,0,1,11
STATION_GUY,45595,5,0,3,8
STATION_GUY,24781,4,2,0,6
GREEDY,26421,10,1,2,13
STINGY,41518,3,0,0,3
UTILITY_GUY,67065,5,0,1,6
DEFAULT,62309,3,1,1,5
GREEDY,24284,8,0,2,10
DEFAULT,20635,10,0,0,10
GREEDY,15098,9,1,1,11
UTILITY_GUY,37430,8,1,2,11
DEFAULT,75626,9,1,0,10
DEFAULT,64416,7,0,0,7
GREEDY,13786,6,0,2,8
UTILITY_GUY,67899,5,1,0,6
GREEDY,11276,8,1,1,10
STATION_GUY,40258,6,0,1,7
DEFAULT,51671,6,0,1,7
STATION_GUY,29255,7,1,1,9
GREEDY,25502,9,1,3,13
STATION_GUY,54692,8,0,2,10
UTILITY_GUY,68213,8,1,1,10
GREEDY,26206,11,1,0,12
STATION_GUY,22383,6,0,3,9
UTILITY_GUY,24332,4,0,0,4
STATION_GUY,22625,3,1,4,8
DEFAULT,36689,5,1,1,7
DEFAULT,43206,5,0,0,5
GREEDY,23543,8,1,1,10
GREEDY,14599,11,1,2,14
GREEDY,17629,8,1,1,10
UTILITY_GUY,22209,5,1,0,6
GREEDY,15188,10,2,0,12
GREEDY,28137,6,0,1,7
STATION_GUY,49624,4,0,0,4
GREEDY,19465,5,0,0,5
GREEDY,20574,11,0,0,11
UTILITY_GUY,67056,6,0,0,6
GREEDY,33328,9,0,2,11
GREEDY,14737,9,1,1,11
GREEDY,17366,6,1,1,8
GREEDY,12619,9,1,1,11
UTILITY_GUY,54570,4,1,0,5
STATION_GUY,73122,7,0,3,10
GREEDY,19451,6,0,0,6
UTILITY_GUY,27373,5,0,0,5
GREEDY,35485,9,0,1,10
UTILITY_GUY,56310,6,0,0,6
GREEDY,19714,10,0,1,11
GREEDY,31007,7,1,0,8
GREEDY,17062,11,0,1,12
GREEDY,21954,8,0,0,8
UTILITY_GUY,43216,4,0,1,5
GREEDY,33271,13,0,0,13
STATION_GUY,52294,7,1,0,8
STATION_GUY,47933,3,0,2,5
UTILITY_GUY,67772,5,1,1,7
UTILITY_GUY,18649,6,2,0,8
GREEDY,26100,8,0,2,10
GREEDY,15168,9,0,1,10
GREEDY,22559,9,1,1,11
UTILITY_GUY,37088,5,0,0,5
GREEDY,18258,6,0,2,8
STATION_GUY,30752,5,1,2,8
GREEDY,20269,10,0,2,12
DEFAULT,54816,9,0,1,10
GREEDY,27000,6,1,2,9
STATION_GUY,59259,5,1,1,7
GREEDY,11034,8,0,1,9
GREEDY,15290,8,0,1,9
GREEDY,21066,8,1,1,10
GREEDY,11101,8,1,2,11
GREEDY,44325,7,1,1,9
STATION_GUY,68459,8,0,2,10
STATION_GUY,44158,3,0,2,5
UTILITY_GUY,42634,6,1,1,8
GREEDY,40731,8,1,0,9
DEFAULT,50745,5,2,0,7
GREEDY,19572,9,2,2,13
GREEDY,18833,9,1,1,11
GREEDY,12391,9,0,0,9
GREEDY,17406,7,1,1,9
GREEDY,14952,8,1,2,11
GREEDY,32387,10,0,0,10
GREEDY,25251,10,0,1,11
GREEDY,13230,13,0,1,14
GREEDY,29618,5,1,0,6
GREEDY,16899,11,0,0,11
STATION_GUY,70847,4,0,4,8
GREEDY,20034,10,1,2,13
GREEDY,73470,9,1,1,11
GREEDY,15332,6,0,1,7
UTILITY_GUY,56113,4,1,0,5
UTILITY_GUY,51416,7,0,1,8
STATION_GUY,24096,3,0,1,4
STATION_GUY,51770,5,0,2,7
GREEDY,22230,8,0,2,10
DEFAULT,31617,6,0,1,7
STATION_GUY,51273,6,1,1,8
GREEDY,11620,9,0,3,12
UTILITY_GUY,58476,2,0,4,6
STATION_GUY,20573,5,0,1,6
GREEDY,50858,8,0,1,9
GREEDY,21886,11,1,1,13
DEFAULT,39855,7,0,0,7
GREEDY,40758,10,0,1,11
UTILITY_GUY,16532,7,0,1,8
GREEDY,24806,10,1,2,13
GREEDY,23140,10,1,3,14
GREEDY,24016,11,0,0,11
GREEDY,25160,7,0,3,10
GREEDY,27157,7,0,1,8
UTILITY_GUY,66306,7,2,0,9
STATION_GUY,48609,7,0,2,9
DEFAULT,12198,5,0,2,7
GREEDY,22349,9,0,1,10
GREEDY,35499,9,1,0,10
DEFAULT,50490,7,0,1,8
GREEDY,19353,11,1,0,12
GREEDY,66481,9,1,0,10
DEFAULT,75907,4,0,1,5
STATION_GUY,7160,7,0,4,11
UTILITY_GUY,29440,5,1,1,7
DEFAULT,65281,6,0,0,6
STATION_GUY,32975,2,1,2,5
GREEDY,17457,8,1,1,10
GREEDY,12727,8,1,3,12
GREEDY,36659,8,0,3,11
GREEDY,16056,7,2,1,10
UTILITY_GUY,23832,6,0,1,7
GREEDY,20659,9,0,1,10
GREEDY,13656,10,1,0,11
STATION_GUY,56821,4,1,1,6
STATION_GUY,42310,4,0,3,7
DEFAULT,60869,7,0,0,7
STATION_GUY,20013,9,0,3,12
UTILITY_GUY,46679,6,1,1,8
DEFAULT,16356,7,2,1,10
DEFAULT,49680,4,1,2,7
GREEDY,18510,8,0,2,10
STATION_GUY,29609,4,0,1,5
GREEDY,15607,10,0,0,10
GREEDY,21261,11,0,0,11
DEFAULT,87145,8,1,1,10
GREEDY,16305,9,0,3,12
GREEDY,34464,12,1,1,14
UTILITY_GUY,94121,8,0,0,8
GREEDY,24862,7,0,2,9
GREEDY,25309,9,1,2,12
GREEDY,24683,9,0,0,9
DEFAULT,95917,8,0,0,8
STATION_GUY,22176,6,0,1,7
UTILITY_GUY,22071,5,0,1,6
GREEDY,26101,9,0,2,11
STATION_GUY,52952,6,0,3,9
GREEDY,19728,8,0,0,8
GREEDY,37473,9,0,0,9
UTILITY_GUY,34932,4,1,0,5
GREEDY,18382,8,0,0,8
GREEDY,25409,11,0,0,11
GREEDY,35792,13,1,0,14
GREEDY,21488,10,0,1,11
UTILITY_GUY,54805,4,1,1,6
GREEDY,23151,6,0,0,6
DEFAULT,48167,6,1,1,8
GREEDY,25588,8,0,1,9
GREEDY,16920,11,0,0,11
GREEDY,18333,8,0,0,8
GREEDY,18786,7,0,3,10
GREEDY,29638,8,0,1,9
GREEDY,16587,9,1,1,11
GREEDY,17920,10,0,0,10
DEFAULT,71607,8,2,0,10
GREEDY,19754,8,1,1,10
GREEDY,24160,11,0,1,12
GREEDY,9763,11,0,0,11
DEFAULT,59261,7,0,0,7
GREEDY,21353,5,1,0,6
DEFAULT,66362,6,1,1,8
STATION_GUY,41932,8,1,2,11
UTILITY_GUY,46911,5,0,0,5
GREEDY,15607,9,0,1,10
DEFAULT,24621,7,1,1,9
GREEDY,18863,7,1,1,9
GREEDY,60120,5,0,3,8
STATION_GUY,24001,7,0,1,8
GREEDY,23247,11,0,1,12
DEFAULT,82913,5,0,0,5
GREEDY,23786,8,1,0,9
GREEDY,15829,8,1,2,11
STATION_GUY,94139,6,0,2,8
UTILITY_GUY,28803,3,1,0,4
GREEDY,20206,10,2,1,13
DEFAULT,84011,9,0,1,10
GREEDY,32625,7,1,0,8
GREEDY,13277,9,0,2,11
GREEDY,17241,9,0,0,9
STATION_GUY,32332,6,0,2,8
GREEDY,30785,9,0,0,9
GREEDY,24942,7,0,1,8
GREEDY,25895,6,1,0,7
GREEDY,71322,10,0,2,12
UTILITY_GUY,34932,9,1,0,10
DEFAULT,35404,8,0,0,8
GREEDY,18977,11,1,1,13
DEFAULT,55311,9,0,0,9
GREEDY,18684,9,0,3,12
GREEDY,17932,11,0,1,12
DEFAULT,55096,3,0,2,5
GREEDY,16899,9,0,1,10
UTILITY_GUY,42955,5,2,2,9
GREEDY,17428,11,0,2,13
GREEDY,28408,7,1,1,9
GREEDY,17836,6,0,1,7
DEFAULT,54131,4,0,1,5
STATION_GUY,97680,6,0,3,9
GREEDY,12684,6,2,1,9
STATION_GUY,37967,4,1,1,6
STATION_GUY,39373,3,0,1,4
DEFAULT,46706,4,1,0,5
GREEDY,32546,9,1,2,12
UTILITY_GUY,49437,8,0,0,8
GREEDY,14304,9,0,0,9
GREEDY,15488,7,1,1,9
GREEDY,24349,7,1,0,8
GREEDY,41397,10,0,1,11
GREEDY,39316,8,0,1,9
GREEDY,10647,9,0,1,10
GREEDY,28267,6,1,3,10
DEFAULT,76127,5,0,0,5
GREEDY,22161,6,0,1,7
DEFAULT,28695,9,1,0,10
STATION_GUY,77492,7,0,2,9
GREEDY,29843,10,0,2,12
GREEDY,14463,11,0,1,12
GREEDY,24791,8,1,0,9
GREEDY,16275,6,0,2,8
GREEDY,19181,6,1,2,9
GREEDY,34397,9,0,1,10
STATION_GUY,89171,8,0,1,9
DEFAULT,52509,8,1,1,10
GREEDY,27449,10,1,2,13
STATION_GUY,49881,9,0,2,11
UTILITY_GUY,45204,5,0,0,5
GREEDY,13162,7,0,3,10
DEFAULT,17943,6,0,0,6
GREEDY,24435,6,2,0,8
GREEDY,20176,9,0,2,11
GREEDY,12429,11,1,0,12
GREEDY,19820,10,0,0,10
UTILITY_GUY,44980,8,0,0,8
GREEDY,26522,7,0,1,8
DEFAULT,47546,5,0,1,6
GREEDY,23386,10,0,0,10
STATION_GUY,50065,5,0,3,8
STATION_GUY,75097,6,0,1,7
STATION_GUY,19213,3,0,4,7
GREEDY,37460,9,0,1,10
UTILITY_GUY,98813,7,1,1,9
GREEDY,14741,7,0,2,9
GREEDY,23999,7,0,3,10
GREEDY,26575,10,0,0,10
STATION_GUY,65873,3,0,4,7
GREEDY,24595,8,1,2,11
DEFAULT,77491,8,0,1,9
UTILITY_GUY,26638,7,1,1,9
GREEDY,26750,12,0,0,12
GREEDY,50221,9,0,1,10
STATION_GUY,36553,6,0,2,8
GREEDY,25217,8,0,0,8
GREEDY,27545,8,1,1,10
GREEDY,23479,9,1,2,12
STATION_GUY,41242,7,1,1,9
UTILITY_GUY,35140,6,1,0,7
GREEDY,25502,8,0,2,10
DEFAULT,75817,5,0,0,5
GREEDY,10706,10,1,0,11
GREEDY,17324,9,1,1,11
DEFAULT,79116,4,1,1,6
GREEDY,21567,10,0,0,10
GREEDY,12437,10,0,1,11
GREEDY,20742,9,2,0,11
UTILITY_GUY,82437,8,1,1,10
STATION_GUY,30826,5,0,3,8
GREEDY,17438,7,1,0,8
GREEDY,17034,10,0,1,11
GREEDY,23193,8,0,1,9
GREEDY,26070,9,0,2,11
GREEDY,19841,9,0,2,11
GREEDY,30809,5,0,1,6
DEFAULT,26613,6,0,0,6
STINGY,13326,2,0,0,2
GREEDY,16822,6,1,1,8
STATION_GUY,29612,4,0,3,7
GREEDY,23423,8,2,1,11
GREEDY,28280,9,1,1,11
STATION_GUY,21987,5,0,0,5
GREEDY,23543,9,1,1,11
GREEDY,21872,8,0,1,9
DEFAULT,55128,8,1,0,9
GREEDY,76336,8,0,1,9
GREEDY,54520,10,0,2,12
DEFAULT,34846,6,0,0,6
UTILITY_GUY,26751,5,0,1,6
UTILITY_GUY,41689,4,2,0,6
DEFAULT,62196,4,0,1,5
DEFAULT,32629,5,1,1,7
GREEDY,14989,7,1,1,9
GREEDY,27714,5,1,3,9
GREEDY,22393,11,0,1,12
GREEDY,18214,10,1,0,11
DEFAULT,49576,6,0,1,7
GREEDY,25416,10,1,1,12
STATION_GUY,12971,5,1,0,6
STATION_GUY,21601,4,1,3,8
GREEDY,14008,9,1,0,10
STATION_GUY,38548,6,0,1,7
DEFAULT,22825,3,1,0,4
GREEDY,14507,7,0,1,8
GREEDY,16450,10,0,0,10
STATION_GUY,29606,7,0,2,9
STINGY,80358,2,1,1,4
STATION_GUY,49715,5,0,3,8
GREEDY,16841,6,0,0,6
GREEDY,60959,10,0,1,11
DEFAULT,88467,6,1,2,9
DEFAULT,19699,3,2,0,5
GREEDY,54578,7,1,1,9
STATION_GUY,17467,5,0,2,7
STATION_GUY,36271,9,0,2,11
GREEDY,56206,10,1,0,11
STATION_GUY,44698,6,0,1,7
GREEDY,24540,8,0,0,8
GREEDY,12589,7,0,0,7
GREEDY,15821,8,0,1,9
GREEDY,20442,14,0,2,16
GREEDY,24278,9,0,2,11
GREEDY,25202,8,1,2,11
DEFAULT,65660,7,1,0,8
GREEDY,19933,6,1,1,8
DEFAULT,30718,7,0,1,8
GREEDY,35635,12,1,2,15
GREEDY,16978,9,0,1,10
GREEDY,34886,10,0,1,11
UTILITY_GUY,36908,5,0,0,5
GREEDY,13459,7,1,4,12
DEFAULT,53839,7,0,0,7
DEFAULT,48479,7,0,2,9
STATION_GUY,26978,4,1,1,6
GREEDY,22713,9,0,0,9
UTILITY_GUY,32276,5,1,1,7
STATION_GUY,63289,6,0,1,7
DEFAULT,40892,8,1,1,10
STATION_GUY,24694,5,1,2,8
DEFAULT,22131,5,2,2,9
DEFAULT,83184,7,0,1,8
DEFAULT,47237,10,0,0,10
UTILITY_GUY,11242,3,1,0,4
GREEDY,14571,10,0,2,12
GREEDY,26619,8,0,1,9
STATION_GUY,17134,4,1,3,8
STATION_GUY,17950,4,0,2,6
DEFAULT,38207,6,0,1,7
UTILITY_GUY,60273,3,0,1,4
GREEDY,16565,7,1,4,12
DEFAULT,73804,10,0,1,11
GREEDY,25935,9,1,0,10
UTILITY_GUY,60959,4,0,1,5
UTILITY_GUY,66320,7,0,2,9
GREEDY,18295,7,1,3,11
GREEDY,22470,9,0,2,11
DEFAULT,54012,5,0,1,6
GREEDY,67057,10,0,0,10
UTILITY_GUY,43085,6,1,0,7
GREEDY,23898,7,0,1,8
STINGY,80252,2,0,0,2
STATION_GUY,23773,3,0,1,4
UTILITY_GUY,42080,7,0,1,8
DEFAULT,19690,7,0,0,7
STATION_GUY,9248,4,0,1,5
DEFAULT,29820,8,1,0,9
DEFAULT,46154,6,1,1,8
STATION_GUY,58891,7,0,2,9
UTILITY_GUY,47149,4,0,0,4
GREEDY,17230,9,1,1,11
UTILITY_GUY,51493,4,0,1,5
GREEDY,69402,12,1,0,13
GREEDY,29216,6,1,2,9
UTILITY_GUY,36477,5,1,0,6
GREEDY,25040,9,0,2,11
STATION_GUY,53888,5,0,2,7
GREEDY,23383,9,0,0,9
DEFAULT,54092,7,1,0,8
DEFAULT,20674,7,0,2,9
STATION_GUY,55094,4,0,4,8
GREEDY,19039,9,0,1,10
GREEDY,25200,7,0,1,8
GREEDY,17975,11,0,0,11
UTILITY_GUY,24707,6,1,1,8
GREEDY,22247,9,0,2,11
DEFAULT,37498,8,0,2,10
DEFAULT,33121,5,1,1,7
GREEDY,14048,11,0,1,12
GREEDY,11770,8,0,2,10
STINGY,96902,5,0,0,5
DEFAULT,39293,8,1,1,10
DEFAULT,69093,6,1,0,7
STATION_GUY,58390,7,1,4,12
DEFAULT,31902,5,1,0,6
STATION_GUY,47296,2,0,0,2
GREEDY,28678,10,0,0,10
DEFAULT,22312,5,1,3,9
GREEDY,30362,12,0,0,12
DEFAULT,47553,6,0,0,6
GREEDY,19969,8,1,0,9
GREEDY,16921,8,0,1,9
GREEDY,12130,10,0,1,11
UTILITY_GUY,34349,6,0,0,6
DEFAULT,66170,10,0,1,11
GREEDY,43997,10,0,1,11
GREEDY,14391,9,0,1,10
GREEDY,23970,5,1,0,6
GREEDY,14267,7,1,0,8
GREEDY,16431,11,0,0,11
GREEDY,33793,12,0,1,13
GREEDY,10925,9,0,2,11
GREEDY,15926,9,0,1,10
DEFAULT,69376,7,0,0,7
GREEDY,12921,9,1,2,12
GREEDY,34876,6,0,0,6
DEFAULT,20346,10,0,1,11
DEFAULT,72003,4,0,2,6
DEFAULT,62049,7,1,1,9
STATION_GUY,18453,4,0,2,6
GREEDY,22791,8,1,1,10
GREEDY,17255,8,0,1,9
DEFAULT,31847,7,1,2,10
DEFAULT,80373,8,0,0,8
STATION_GUY,26872,4,1,2,7
DEFAULT,39824,5,0,1,6
GREEDY,21002,7,1,2,10
STATION_GUY,23620,4,0,4,8
GREEDY,20359,7,1,0,8
DEFAULT,62885,8,0,2,10
UTILITY_GUY,41394,7,0,0,7
DEFAULT,35399,4,0,0,4
GREEDY,28683,12,1,0,13
UTILITY_GUY,18363,5,1,1,7
GREEDY,76731,10,1,0,11
GREEDY,19973,10,0,1,11
DEFAULT,44102,5,2,0,7
GREEDY,22498,9,1,2,12
GREEDY,28262,8,1,1,10
UTILITY_GUY,61880,9,1,1,11
GREEDY,34366,10,0,1,11
GREEDY,85221,9,1,0,10
UTILITY_GUY,27872,5,1,0,6
GREEDY,75680,7,2,0,9
DEFAULT,66098,10,1,0,11
UTILITY_GUY,36408,7,0,0,7
GREEDY,30873,9,1,1,11
STATION_GUY,19179,7,0,2,9
GREEDY,25722,10,1,3,14
GREEDY,20741,5,1,1,7
GREEDY,21929,8,0,1,9
GREEDY,27602,11,0,2,13
DEFAULT,31067,7,0,1,8
DEFAULT,90521,5,0,0,5
GREEDY,19388,9,1,0,10
STATION_GUY,30385,4,0,3,7
GREEDY,27527,8,1,1,10
GREEDY,39553,10,0,0,10
GREEDY,19912,7,0,0,7
GREEDY,22412,7,0,1,8
STATION_GUY,25852,7,1,0,8
STINGY,98127,5,0,0,5
STATION_GUY,71383,5,1,2,8
STATION_GUY,18739,5,0,0,5
STATION_GUY,11802,2,0,4,6
UTILITY_GUY,23409,4,1,1,6
GREEDY,26026,8,1,1,10
DEFAULT,22924,7,0,2,9
UTILITY_GUY,35347,5,1,0,6
STATION_GUY,8516,1,0,4,5
GREEDY,27890,10,0,1,11
GREEDY,19431,8,0,1,9
DEFAULT,30982,6,0,1,7
GREEDY,21205,8,0,1,9
UTILITY_GUY,64933,8,0,1,9
GREEDY,27711,7,0,0,7
GREEDY,20195,7,1,0,8
GREEDY,46121,7,1,2,10
GREEDY,27164,6,1,0,7
GREEDY,79495,8,0,2,10
GREEDY,26484,7,0,0,7
DEFAULT,35786,6,0,2,8
STATION_GUY,34811,8,1,1,10
GREEDY,18447,9,0,0,9
DEFAULT,57909,7,1,1,9
GREEDY,11805,8,0,0,8
GREEDY,26885,12,0,1,13
GREEDY,45706,6,1,0,7
GREEDY,39023,4,1,4,9
UTILITY_GUY,25343,8,1,1,10
UTILITY_GUY,50098,5,0,1,6
GREEDY,29556,11,1,1,13
GREEDY,19227,7,0,1,8
GREEDY,15617,10,1,0,11
UTILITY_GUY,28626,8,0,1,9
GREEDY,28637,10,0,1,11
GREEDY,16174,11,0,1,12
GREEDY,18995,10,0,1,11
DEFAULT,31403,7,0,1,8
DEFAULT,37017,8,0,0,8
GREEDY,48437,7,1,2,10
GREEDY,20892,5,0,2,7
GREEDY,11719,8,0,1,9
STATION_GUY,26094,4,0,4,8
DEFAULT,13881,7,1,0,8
GREEDY,41607,10,1,1,12
GREEDY,16803,11,0,1,12
GREEDY,20510,12,0,0,12
GREEDY,17203,8,1,1,10
STATION_GUY,56307,3,1,0,4
GREEDY,16691,10,0,1,11
GREEDY,26421,7,0,2,9
STATION_GUY,22426,6,0,0,6
DEFAULT,19900,6,1,0,7
GREEDY,26070,9,0,3,12
GREEDY,21031,8,1,1,10
STATION_GUY,15292,9,0,2,11
GREEDY,49876,7,0,0,7
GREEDY,32690,8,0,2,10
GREEDY,16653,10,1,1,12
GREEDY,17706,9,0,1,10
GREEDY,11574,8,1,0,9
GREEDY,15494,5,1,1,7
GREEDY,31822,9,1,0,10
DEFAULT,86387,5,0,1,6
GREEDY,27000,8,0,1,9
DEFAULT,76096,7,0,0,7
GREEDY,21580,10,2,1,13
GREEDY,23342,6,1,1,8
STATION_GUY,79974,5,1,4,10
GREEDY,92850,10,0,1,11
GREEDY,26755,10,0,2,12
GREEDY,20553,6,1,1,8
STATION_GUY,21992,4,0,1,5
GREEDY,50373,9,1,0,10
STATION_GUY,61008,5,0,4,9
GREEDY,16252,7,0,1,8
GREEDY,19958,9,0,2,11
DEFAULT,13722,6,1,0,7
GREEDY,26750,6,1,1,8
DEFAULT,53434,5,1,1,7
GREEDY,22994,9,0,1,10
DEFAULT,79219,6,0,1,7
UTILITY_GUY,54824,5,1,0,6
GREEDY,12326,9,1,2,12
STATION_GUY,67050,6,2,0,8
GREEDY,11493,11,1,2,14
GREEDY,9510,11,0,2,13
DEFAULT,23751,4,0,0,4
DEFAULT,28374,8,0,0,8
GREEDY,23230,8,0,0,8
GREEDY,16785,11,1,1,13
GREEDY,71647,10,0,1,11
STINGY,96941,3,0,0,3
UTILITY_GUY,39298,4,1,0,5
GREEDY,18252,10,0,2,12
GREEDY,24473,7,2,0,9
GREEDY,25837,9,1,1,11
GREEDY,76399,11,0,0,11
GREEDY,21974,7,1,1,9
GREEDY,31014,8,2,2,12
GREEDY,9255,7,1,0,8
UTILITY_GUY,95188,4,0,0,4
GREEDY,19704,5,1,1,7
STATION_GUY,29889,6,1,1,8
DEFAULT,29699,5,0,0,5
DEFAULT,40506,7,0,0,7
GREEDY,47366,8,0,0,8
STATION_GUY,41939,5,1,0,6
GREEDY,14627,6,1,1,8
GREEDY,16556,11,0,2,13
GREEDY,19810,10,0,2,12
GREEDY,21372,6,1,1,8
STATION_GUY,45263,7,0,2,9
GREEDY,37317,8,0,0,8
DEFAULT,72927,5,0,2,7
UTILITY_GUY,52239,3,2,2,7
DEFAULT,29611,4,0,0,4
GREEDY,15671,5,0,3,8
STATION_GUY,80852,10,0,2,12
STATION_GUY,55380,5,0,2,7
GREEDY,14535,11,1,0,12
DEFAULT,61521,8,0,0,8
GREEDY,20007,6,1,1,8
STATION_GUY,42718,4,1,0,5
UTILITY_GUY,52733,8,0,0,8
GREEDY,13144,7,0,1,8
UTILITY_GUY,43329,8,1,0,9
GREEDY,64329,10,1,1,12
STATION_GUY,33085,6,0,1,7
GREEDY,14734,9,0,1,10
STATION_GUY,25671,4,0,2,6
GREEDY,15312,8,0,0,8
GREEDY,64405,9,1,0,10
GREEDY,79763,8,0,1,9
UTILITY_GUY,49089,4,1,0,5
GREEDY,13424,12,0,0,12
UTILITY_GUY,73473,8,0,1,9
GREEDY,20628,12,1,1,14
STINGY,41426,2,0,0,2
DEFAULT,61748,8,1,1,10
STATION_GUY,23864,9,1,2,12
STATION_GUY,67216,5,1,1,7
GREEDY,15721,9,0,0,9
GREEDY,33741,11,0,0,11
GREEDY,13342,7,0,0,7
UTILITY_GUY,45518,3,1,0,4
DEFAULT,35687,6,0,0,6
STATION_GUY,11001,1,0,4,5
GREEDY,15127,7,1,0,8
STINGY,90372,5,0,0,5
GREEDY,82411,9,0,3,12
GREEDY,18511,8,1,1,10
DEFAULT,33073,7,0,1,8
UTILITY_GUY,59756,5,0,1,6
GREEDY,20099,8,1,0,9
GREEDY,38907,10,0,0,10
UTILITY_GUY,24400,6,0,0,6
STATION_GUY,32475,4,0,1,5
UTILITY_GUY,26879,5,0,0,5
DEFAULT,95521,7,0,1,8
GREEDY,13930,7,0,1,8
GREEDY,14291,9,1,1,11
GREEDY,43917,7,2,1,10
GREEDY,18044,10,2,1,13
GREEDY,27203,7,0,0,7
GREEDY,25310,10,0,2,12
GREEDY,22267,9,0,0,9
DEFAULT,37644,9,1,1,11
GREEDY,33347,12,0,1,13
GREEDY,41702,10,0,2,12
DEFAULT,61959,9,0,0,9
GREEDY,15744,8,1,1,10
STATION_GUY,42184,5,1,2,8
GREEDY,32342,9,0,1,10
STATION_GUY,35530,5,0,2,7
GREEDY,21299,9,0,0,9
GREEDY,35621,8,1,1,10
DEFAULT,37790,5,0,0,5
GREEDY,25279,8,0,2,10
GREEDY,80602,6,1,0,7
GREEDY,52217,9,0,1,10
GREEDY,24944,10,0,1,11
GREEDY,20756,9,1,2,12
UTILITY_GUY,24306,7,0,0,7
DEFAULT,51675,6,0,1,7
GREEDY,61562,11,0,1,12
DEFAULT,36603,7,1,0,8
STATION_GUY,58910,6,0,2,8
GREEDY,62934,9,1,1,11
GREEDY,15391,12,0,0,12
STATION_GUY,83639,3,0,0,3
STATION_GUY,37548,6,0,2,8
GREEDY,14851,7,0,2,9
GREEDY,23484,9,1,2,12
DEFAULT,31763,8,0,0,8
GREEDY,18671,10,0,0,10
DEFAULT,36431,9,0,1,10
GREEDY,40130,6,1,1,8
UTILITY_GUY,55228,3,2,0,5
GREEDY,15316,8,0,1,9
GREEDY,18875,10,0,1,11
GREEDY,16329,9,1,2,12
DEFAULT,24845,4,0,1,5
DEFAULT,26547,9,0,0,9
STATION_GUY,34740,7,1,1,9
GREEDY,26984,6,2,0,8
STATION_GUY,53101,3,1,2,6
GREEDY,25325,10,1,2,13
GREEDY,17512,9,1,0,10
DEFAULT,44734,8,2,1,11
GREEDY,13191,9,0,2,11
STATION_GUY,28162,8,0,2,10
STATION_GUY,55728,4,0,1,5
GREEDY,21128,8,0,2,10
GREEDY,12858,10,0,0,10
DEFAULT,17429,8,1,1,10
GREEDY,87104,9,0,2,11
GREEDY,25366,8,0,1,9
STATION_GUY,46004,1,1,4,6
GREEDY,24838,9,1,1,11
GREEDY,56858,10,1,1,12
GREEDY,20443,8,1,0,9
STATION_GUY,53268,4,1,1,6
GREEDY,17022,9,0,3,12
DEFAULT,74486,8,1,0,9
GREEDY,35796,12,0,1,13
DEFAULT,37142,10,0,0,10
GREEDY,99964,7,0,1,8
STATION_GUY,21738,7,1,1,9
GREEDY,81130,9,2,1,12
GREEDY,38669,6,0,3,9
GREEDY,26011,7,1,0,8
STATION_GUY,59192,4,1,2,7
STATION_GUY,26005,6,1,4,11
DEFAULT,77061,6,2,1,9
GREEDY,79769,10,0,3,13
GREEDY,45681,9,0,1,10
STATION_GUY,68298,5,1,2,8
DEFAULT,14979,4,0,1,5
DEFAULT,50924,9,0,0,9
GREEDY,18827,9,1,0,10
GREEDY,19183,8,1,2,11
GREEDY,53582,9,1,2,12
STATION_GUY,44404,6,0,1,7
DEFAULT,40683,7,1,0,8
GREEDY,32960,12,0,1,13
GREEDY,26070,10,0,0,10
UTILITY_GUY,25168,5,0,1,6
GREEDY,41359,10,0,0,10
GREEDY,16596,8,0,0,8
GREEDY,55727,10,1,1,12
GREEDY,18037,7,1,0,8
GREEDY,16881,7,1,1,9
GREEDY,88498,9,1,2,12
GREEDY,19410,7,0,2,9
GREEDY,33639,10,0,2,12
GREEDY,44598,8,0,1,9
GREEDY,52581,9,0,1,10
STATION_GUY,40912,7,0,2,9
GREEDY,21069,6,1,2,9
GREEDY,12379,10,0,1,11
STATION_GUY,29819,3,0,2,5
UTILITY_GUY,36443,6,1,0,7
GREEDY,77776,9,0,0,9
GREEDY,31043,11,1,1,13
GREEDY,15675,7,0,2,9
GREEDY,78258,11,1,2,14
GREEDY,64122,8,0,1,9
STATION_GUY,63015,6,0,2,8
STATION_GUY,15132,3,0,1,4
GREEDY,24943,8,1,0,9
STATION_GUY,13212,6,0,2,8
STATION_GUY,24910,7,0,1,8
UTILITY_GUY,6793,3,1,4,8
STATION_GUY,54044,5,0,1,6
GREEDY,28146,7,1,2,10
GREEDY,33110,8,1,1,10
GREEDY,37874,9,0,1,10
DEFAULT,33654,9,0,2,11
GREEDY,35007,9,1,1,11
DEFAULT,97809,6,1,0,7
UTILITY_GUY,36990,7,0,1,8
GREEDY,22750,12,1,0,13
GREEDY,14200,8,1,2,11
GREEDY,21138,10,0,1,11
DEFAULT,22649,5,1,1,7
STATION_GUY,22188,8,0,3,11
STATION_GUY,10842,2,1,4,7
GREEDY,18691,10,1,1,12
DEFAULT,20834,6,0,3,9
DEFAULT,44191,5,0,1,6
UTILITY_GUY,39290,3,1,1,5
UTILITY_GUY,38468,4,0,0,4
GREEDY,22580,9,0,1,10
GREEDY,17758,8,1,1,10
UTILITY_GUY,34550,5,0,0,5
GREEDY,17026,8,0,1,9
GREEDY,11938,11,1,2,14
GREEDY,58852,8,0,4,12
GREEDY,15854,6,2,1,9
GREEDY,16434,6,1,0,7
GREEDY,19517,10,0,2,12
GREEDY,15919,10,1,1,12
STATION_GUY,31051,6,0,2,8
GREEDY,31003,6,1,0,7
STATION_GUY,56884,8,1,2,11
STATION_GUY,39961,3,0,2,5
GREEDY,14417,11,0,0,11
GREEDY,69834,10,0,0,10
GREEDY,14142,9,2,0,11
DEFAULT,31975,6,0,0,6
GREEDY,27701,7,2,2,11
GREEDY,13749,10,1,3,14
DEFAULT,87490,9,0,0,9
GREEDY,12735,9,0,1,10
STATION_GUY,55123,9,0,0,9
GREEDY,55870,7,0,0,7
GREEDY,14969,9,1,3,13
GREEDY,19144,7,2,1,10
GREEDY,17637,5,2,3,10
UTILITY_GUY,38935,4,1,2,7
GREEDY,31231,11,1,1,13
GREEDY,11669,8,1,1,10
DEFAULT,48089,7,0,1,8
GREEDY,26179,8,1,0,9
STATION_GUY,93601,5,0,1,6
GREEDY,79463,10,0,2,12
STATION_GUY,60294,4,0,2,6
GREEDY,35953,10,0,0,10
STINGY,78763,3,0,1,4
STATION_GUY,49551,5,0,2,7
UTILITY_GUY,30945,8,0,0,8
STATION_GUY,49209,5,0,0,5
GREEDY,14902,7,0,4,11
GREEDY,15278,8,1,0,9
STATION_GUY,28004,7,1,1,9
STATION_GUY,24946,5,0,1,6
GREEDY,24462,7,0,0,7
GREEDY,24010,9,0,0,9
GREEDY,15481,9,0,0,9
GREEDY,26079,8,0,0,8
UTILITY_GUY,46623,7,0,0,7
GREEDY,7783,9,1,0,10
GREEDY,34608,9,0,1,10
GREEDY,22968,5,0,4,9
GREEDY,25904,6,1,2,9
GREEDY,8220,7,0,3,10
GREEDY,64010,10,0,1,11
GREEDY,22903,6,0,3,9
GREEDY,16682,6,1,1,8
GREEDY,24019,9,0,1,10
UTILITY_GUY,40611,8,1,0,9
GREEDY,22952,8,1,2,11
GREEDY,21428,10,0,1,11
GREEDY,20223,10,0,0,10
UTILITY_GUY,32777,5,1,0,6
GREEDY,58933,10,0,0,10
DEFAULT,75894,6,1,2,9
DEFAULT,38263,7,1,2,10
GREEDY,13682,6,0,2,8
GREEDY,20574,8,0,2,10
GREEDY,21780,8,0,0,8
DEFAULT,30347,5,0,1,6
GREEDY,13999,5,0,1,6
GREEDY,19780,8,1,2,11
GREEDY,20246,7,1,2,10
GREEDY,45491,8,0,1,9
GREEDY,53504,7,1,2,10
DEFAULT,50201,8,0,1,9
GREEDY,26097,8,1,2,11
STATION_GUY,24122,8,0,1,9
UTILITY_GUY,44105,8,0,0,8
STATION_GUY,36686,6,0,2,8
DEFAULT,60775,7,0,1,8
GREEDY,35568,9,0,2,11
GREEDY,34631,8,0,2,10
UTILITY_GUY,17703,4,0,0,4
DEFAULT,55999,5,0,1,6
STATION_GUY,55263,7,0,1,8
DEFAULT,29828,8,0,1,9
GREEDY,11934,12,0,0,12
GREEDY,19862,8,0,0,8
DEFAULT,49029,7,0,1,8
GREEDY,23515,9,2,0,11
STATION_GUY,31454,7,1,1,9
GREEDY,21999,10,0,1,11
STATION_GUY,38026,5,0,1,6
GREEDY,63416,8,1,1,10
GREEDY,38033,9,0,1,10
GREEDY,19598,11,0,2,13
UTILITY_GUY,31824,6,0,2,8
GREEDY,31769,10,0,1,11
DEFAULT,47687,4,0,1,5
GREEDY,30640,8,1,1,10
GREEDY,46006,10,1,2,13
DEFAULT,37702,6,0,1,7
GREEDY,20561,5,0,3,8
GREEDY,33994,10,0,1,11
DEFAULT,52420,5,0,1,6
STATION_GUY,45634,6,0,1,7
GREEDY,30760,8,0,1,9
STATION_GUY,68408,7,0,1,8
GREEDY,18843,9,1,0,10
GREEDY,80013,9,1,0,10
GREEDY,21299,9,0,0,9
GREEDY,16227,10,0,0,10
GREEDY,31866,9,2,1,12
GREEDY,46567,9,0,1,10
GREEDY,26691,12,2,1,15
GREEDY,13832,6,1,1,8
GREEDY,22435,6,0,2,8
GREEDY,23475,11,0,0,11
GREEDY,10635,8,0,1,9
UTILITY_GUY,37976,3,0,0,3
GREEDY,28796,9,2,1,12
GREEDY,21390,11,0,0,11
DEFAULT,86051,9,0,1,10
GREEDY,31277,11,1,2,14
DEFAULT,63161,6,0,1,7
GREEDY,11741,9,1,1,11
STATION_GUY,26664,3,0,1,4
GREEDY,24308,10,1,2,13
GREEDY,74274,10,1,2,13
STATION_GUY,55110,7,0,1,8
UTILITY_GUY,52588,6,0,0,6
GREEDY,21884,14,1,1,16
GREEDY,15666,8,0,0,8
GREEDY,25576,10,1,3,14
GREEDY,15756,12,0,0,12
DEFAULT,33547,3,1,4,8
GREEDY,27364,9,0,2,11
GREEDY,26259,7,0,2,9
DEFAULT,48022,10,1,0,11
UTILITY_GUY,17559,7,1,1,9
UTILITY_GUY,55019,3,1,2,6
GREEDY,17627,9,0,1,10
GREEDY,19634,9,0,1,10
GREEDY,26026,7,1,1,9
DEFAULT,23366,7,1,1,9
DEFAULT,44107,7,1,2,10
GREEDY,18458,8,0,1,9
DEFAULT,67102,6,1,0,7
GREEDY,68129,5,0,4,9
GREEDY,22375,6,1,1,8
GREEDY,13397,10,1,2,13
GREEDY,28541,9,0,1,10
GREEDY,23813,10,0,1,11
STATION_GUY,35167,7,0,1,8
GREEDY,27901,5,0,3,8
GREEDY,29573,10,0,1,11
GREEDY,33640,11,0,1,12
STATION_GUY,27709,5,0,1,6
GREEDY,21624,12,1,1,14
GREEDY,15647,9,1,1,11
STATION_GUY,26447,3,0,1,4
GREEDY,22169,9,0,2,11
DEFAULT,32893,7,0,1,8
GREEDY,18797,7,2,1,10
GREEDY,24031,8,1,2,11
UTILITY_GUY,40457,5,0,0,5
STATION_GUY,16537,6,0,2,8
GREEDY,15172,10,1,1,12
GREEDY,36354,8,1,3,12
GREEDY,19590,10,1,1,12
GREEDY,16991,8,0,2,10
GREEDY,12233,7,2,2,11
GREEDY,17413,6,1,1,8
GREEDY,10957,8,0,0,8
DEFAULT,26694,7,0,0,7
GREEDY,12516,10,0,1,11
GREEDY,18576,9,0,2,11
GREEDY,14178,10,0,0,10
GREEDY,30634,8,0,2,10
STATION_GUY,81193,6,0,2,8
UTILITY_GUY,47842,4,1,1,6
DEFAULT,50551,7,0,0,7
DEFAULT,51524,4,0,1,5
STATION_GUY,59433,6,0,1,7
DEFAULT,27418,9,0,1,10
UTILITY_GUY,32999,3,1,1,5
GREEDY,47590,9,0,1,10
UTILITY_GUY,53716,3,0,0,3
GREEDY,54130,10,1,0,11
UTILITY_GUY,34572,5,0,1,6
GREEDY,10790,10,0,1,11
DEFAULT,58082,6,0,0,6
GREEDY,78746,9,1,0,10
GREEDY,64738,10,1,0,11
GREEDY,17246,9,0,1,10
STATION_GUY,19793,8,0,1,9
GREEDY,42374,11,0,0,11
STATION_GUY,15830,5,0,1,6
DEFAULT,29033,8,0,0,8
GREEDY,11977,8,1,0,9
GREEDY,33612,5,0,0,5
GREEDY,20712,10,1,2,13
DEFAULT,28154,7,0,0,7
GREEDY,21124,9,1,2,12
STATION_GUY,49845,7,0,1,8
GREEDY,25499,8,0,1,9
UTILITY_GUY,67112,4,0,1,5
STATION_GUY,44069,4,0,2,6
GREEDY,17529,6,0,2,8
DEFAULT,34383,5,1,1,7
UTILITY_GUY,99853,4,0,0,4
GREEDY,21636,7,0,0,7
GREEDY,19542,10,0,2,12
GREEDY,23691,7,1,4,12
UTILITY_GUY,46622,5,0,1,6
STATION_GUY,30493,7,0,1,8
STATION_GUY,30106,4,0,1,5
GREEDY,35734,7,1,1,9
GREEDY,15354,8,1,0,9
STATION_GUY,70029,6,0,1,7
GREEDY,25877,7,0,1,8
GREEDY,27316,10,0,1,11
GREEDY,20781,9,0,1,10
DEFAULT,28242,5,0,2,7
GREEDY,24543,6,0,2,8
GREEDY,57306,7,2,1,10
DEFAULT,23672,5,1,1,7
GREEDY,15741,8,0,1,9
GREEDY,37098,8,1,1,10
DEFAULT,51295,4,0,0,4
GREEDY,32720,9,0,3,12
STATION_GUY,69988,5,0,0,5
STATION_GUY,29861,5,0,0,5
STATION_GUY,26230,4,1,2,7
GREEDY,19468,10,0,0,10
UTILITY_GUY,73529,4,1,1,6
GREEDY,41458,7,0,3,10
STATION_GUY,59004,6,0,3,9
DEFAULT,55355,5,1,1,7
GREEDY,36999,7,2,0,9
STATION_GUY,33208,5,1,1,7
DEFAULT,58845,6,1,0,7
STATION_GUY,34960,7,1,1,9
GREEDY,59304,8,0,2,10
DEFAULT,92545,5,0,0,5
DEFAULT,21079,4,0,2,6
GREEDY,21625,13,0,0,13
GREEDY,43429,9,0,0,9
UTILITY_GUY,31732,7,1,1,9
GREEDY,18124,9,1,0,10
GREEDY,15491,10,0,1,11
GREEDY,17063,11,0,2,13
UTILITY_GUY,34860,6,0,1,7
GREEDY,18176,10,0,2,12
UTILITY_GUY,48250,4,0,0,4
DEFAULT,28524,3,0,2,5
STATION_GUY,24805,4,1,1,6
DEFAULT,17432,7,1,0,8
GREEDY,15314,11,1,1,13
DEFAULT,50439,5,1,0,6
DEFAULT,96528,8,0,0,8
DEFAULT,42527,6,1,0,7
STATION_GUY,80002,5,1,2,8
DEFAULT,25611,3,0,1,4
STATION_GUY,25635,4,1,4,9
UTILITY_GUY,46740,5,0,1,6
GREEDY,25587,9,0,1,10
GREEDY,32517,8,1,0,9
UTILITY_GUY,45215,5,0,0,5
GREEDY,12892,11,0,0,11
GREEDY,18159,10,1,1,12
GREEDY,30920,8,1,0,9
GREEDY,26622,8,0,0,8
GREEDY,10965,7,0,0,7
GREEDY,76908,9,1,0,10
UTILITY_GUY,47879,5,1,1,7
UTILITY_GUY,74622,4,1,1,6
GREEDY,43398,9,1,1,11
UTILITY_GUY,25625,6,0,1,7
GREEDY,24625,7,0,2,9
STATION_GUY,14706,4,0,4,8
GREEDY,24873,6,1,0,7
DEFAULT,84829,5,0,0,5
GREEDY,91108,13,1,1,15
STATION_GUY,26378,9,0,1,10
GREEDY,23314,7,0,2,9
UTILITY_GUY,44742,6,0,1,7
DEFAULT,44313,7,0,2,9
GREEDY,38323,11,1,1,13
GREEDY,47271,10,1,3,14
GREEDY,28685,3,0,1,4
DEFAULT,35971,9,0,0,9
GREEDY,17149,7,1,1,9
GREEDY,32944,9,1,0,10
GREEDY,26767,10,0,1,11
DEFAULT,84218,10,0,0,10
DEFAULT,40992,5,0,0,5
UTILITY_GUY,80142,6,0,1,7
DEFAULT,29554,8,1,0,9
DEFAULT,47881,9,0,2,11
GREEDY,27024,7,1,1,9
DEFAULT,56878,8,0,1,9
STATION_GUY,40551,5,1,1,7
GREEDY,31489,8,1,2,11
UTILITY_GUY,60808,7,0,0,7
GREEDY,28571,7,1,1,9
GREEDY,17849,8,1,0,9
DEFAULT,64310,9,0,1,10
DEFAULT,86577,7,0,0,7
GREEDY,14400,10,0,1,11
GREEDY,16833,9,1,2,12
GREEDY,26239,8,1,1,10
GREEDY,22652,7,1,1,9
GREEDY,60675,7,0,4,11
GREEDY,33287,7,1,1,9
GREEDY,12094,12,0,4,16
STATION_GUY,48395,9,1,0,10
DEFAULT,63142,6,0,0,6
GREEDY,18903,4,1,0,5
DEFAULT,59346,5,0,1,6
GREEDY,27349,12,1,2,15
DEFAULT,15876,6,0,0,6
GREEDY,14370,8,0,1,9
GREEDY,13781,9,0,0,9
GREEDY,19630,10,0,2,12
GREEDY,16479,12,0,1,13
GREEDY,23077,7,0,1,8
GREEDY,19050,12,0,1,13
DEFAULT,65529,6,1,0,7
GREEDY,16564,10,0,0,10
DEFAULT,20872,6,0,0,6
GREEDY,96183,8,0,0,8
STATION_GUY,25481,10,1,3,14
GREEDY,27826,7,1,1,9
GREEDY,23530,7,0,1,8
GREEDY,15139,10,0,0,10
GREEDY,16838,9,1,0,10
UTILITY_GUY,40521,3,1,0,4
GREEDY,18236,9,1,1,11
UTILITY_GUY,36252,6,0,0,6
GREEDY,21828,5,0,1,6
GREEDY,22917,9,0,0,9
GREEDY,15478,8,0,1,9
GREEDY,21211,9,2,1,12
GREEDY,77905,9,0,1,10
UTILITY_GUY,58605,6,0,0,6
GREEDY,31139,12,1,1,14
GREEDY,21007,5,0,1,6
STATION_GUY,79143,5,1,2,8
DEFAULT,38945,9,0,0,9
GREEDY,25215,13,1,2,16
GREEDY,15197,7,1,2,10
DEFAULT,54266,9,0,1,10
UTILITY_GUY,51383,5,0,1,6
GREEDY,22312,10,0,1,11
STATION_GUY,26399,6,0,1,7
UTILITY_GUY,38741,5,1,0,6
DEFAULT,19909,7,0,0,7
GREEDY,26931,9,0,0,9
GREEDY,28044,10,1,0,11
GREEDY,30839,9,0,2,11
GREEDY,17721,11,0,0,11
GREEDY,56355,8,2,2,12
STATION_GUY,25991,9,1,0,10
DEFAULT,36403,9,0,0,9
GREEDY,13529,8,0,1,9
GREEDY,15513,12,1,2,15
GREEDY,18216,9,1,1,11
DEFAULT,65043,9,0,1,10
GREEDY,59401,8,0,4,12
GREEDY,18042,12,1,0,13
GREEDY,14743,6,0,2,8
DEFAULT,20729,6,0,4,10
GREEDY,33347,8,1,2,11
STATION_GUY,64057,5,0,2,7
STATION_GUY,33416,5,1,2,8
GREEDY,22566,7,1,1,9
STATION_GUY,35280,7,1,0,8
GREEDY,21230,4,0,2,6
GREEDY,23846,7,0,3,10
GREEDY,27001,9,0,0,9
GREEDY,31166,8,1,1,10
GREEDY,21411,8,0,2,10
DEFAULT,22401,9,0,1,10
GREEDY,32541,8,1,3,12
GREEDY,32478,6,1,1,8
GREEDY,22789,9,0,1,10
STATION_GUY,25026,7,0,2,9
UTILITY_GUY,61258,5,1,0,6
GREEDY,30395,7,0,1,8
STATION_GUY,59164,5,0,2,7
GREEDY,29848,9,0,2,11
UTILITY_GUY,44713,6,1,0,7
GREEDY,33740,9,1,1,11
UTILITY_GUY,93537,4,1,1,6
GREEDY,24754,8,0,2,10
DEFAULT,56630,6,0,1,7
GREEDY,20097,9,1,0,10
DEFAULT,41571,5,1,2,8
UTILITY_GUY,83173,4,2,0,6
GREEDY,15478,13,0,1,14
UTILITY_GUY,22178,5,1,0,6
DEFAULT,40854,5,0,3,8
DEFAULT,35426,8,1,2,11
UTILITY_GUY,16369,6,1,0,7
DEFAULT,52584,8,1,1,10
DEFAULT,40908,8,0,1,9
GREEDY,22432,10,1,0,11
STATION_GUY,82006,5,0,1,6
GREEDY,9641,11,0,0,11
GREEDY,24242,8,2,1,11
DEFAULT,31951,8,1,1,10
DEFAULT,71247,7,0,0,7
GREEDY,49693,7,0,0,7
GREEDY,10083,7,0,2,9
UTILITY_GUY,43173,9,1,1,11
GREEDY,27007,8,1,2,11
GREEDY,38951,11,0,0,11
DEFAULT,59589,9,0,0,9
GREEDY,19463,5,0,2,7
DEFAULT,48589,7,1,1,9
GREEDY,21092,10,0,1,11
DEFAULT,32890,8,1,0,9
GREEDY,17411,7,1,2,10
DEFAULT,43381,9,0,0,9
GREEDY,19630,11,0,1,12
GREEDY,24038,6,0,2,8
GREEDY,26646,8,2,1,11
GREEDY,19922,6,1,0,7
GREEDY,7620,11,0,1,12
GREEDY,13075,7,0,1,8
UTILITY_GUY,81806,7,1,0,8
GREEDY,45739,9,0,1,10
STATION_GUY,63550,4,0,2,6
GREEDY,29974,7,0,1,8
DEFAULT,16217,6,0,1,7
UTILITY_GUY,45062,6,0,0,6
UTILITY_GUY,25093,7,1,0,8
GREEDY,33460,8,0,1,9
STATION_GUY,51734,5,0,2,7
DEFAULT,33551,7,0,1,8
DEFAULT,28141,7,0,0,7
GREEDY,15016,7,0,0,7
DEFAULT,30818,5,0,2,7
GREEDY,16765,6,0,1,7
GREEDY,11358,9,0,1,10
GREEDY,13303,10,1,0,11
STATION_GUY,99563,5,1,0,6
DEFAULT,72439,8,1,0,9
DEFAULT,30281,6,0,1,7
GREEDY,41712,10,0,0,10
STATION_GUY,49094,8,0,2,10
GREEDY,69304,12,0,0,12
STATION_GUY,44076,5,0,0,5
GREEDY,17547,9,1,3,13
GREEDY,43579,11,0,2,13
GREEDY,17209,8,1,1,10
UTILITY_GUY,16740,4,1,0,5
GREEDY,33955,10,0,0,10
DEFAULT,94487,4,0,1,5
GREEDY,26599,10,1,2,13
GREEDY,27804,10,0,0,10
UTILITY_GUY,39738,7,1,0,8
GREEDY,30599,12,0,2,14
GREEDY,20382,12,0,2,14
GREEDY,24690,8,0,3,11
GREEDY,25254,10,1,0,11
DEFAULT,43741,7,1,1,9
UTILITY_GUY,19694,4,1,1,6
GREEDY,16010,10,0,2,12
STATION_GUY,35176,4,0,2,6
DEFAULT,71631,5,0,2,7
GREEDY,23512,7,0,2,9
DEFAULT,66290,8,0,1,9
DEFAULT,52984,6,0,0,6
GREEDY,20811,6,1,1,8
GREEDY,20514,10,0,1,11
GREEDY,28161,4,0,1,5
GREEDY,31935,9,0,0,9
GREEDY,17945,13,1,0,14
GREEDY,19632,8,0,0,8
GREEDY,13372,7,1,1,9
GREEDY,28194,11,0,1,12
GREEDY,26431,10,0,1,11
GREEDY,18251,4,0,1,5
STATION_GUY,52933,9,0,2,11
GREEDY,21910,10,0,2,12
GREEDY,26671,7,1,4,12
GREEDY,14023,11,0,1,12
DEFAULT,41252,4,0,0,4
GREEDY,21496,11,2,1,14
UTILITY_GUY,26591,5,1,0,6
DEFAULT,21485,4,1,0,5
GREEDY,74543,9,1,1,11
UTILITY_GUY,10792,7,0,2,9
DEFAULT,30325,9,0,1,10
GREEDY,22713,9,0,0,9
DEFAULT,48040,7,0,1,8
UTILITY_GUY,46860,2,0,1,3
DEFAULT,27169,5,0,0,5
GREEDY,19396,12,1,0,13
UTILITY_GUY,12630,8,0,1,9
GREEDY,47168,5,1,4,10
STATION_GUY,29530,2,1,4,7
GREEDY,12203,7,0,4,11
UTILITY_GUY,20721,4,1,1,6
STATION_GUY,47249,7,0,1,8
UTILITY_GUY,13054,5,0,0,5
DEFAULT,64428,8,0,1,9
DEFAULT,23611,5,0,0,5
GREEDY,13675,9,1,0,10
STATION_GUY,45355,7,0,1,8
GREEDY,71942,11,1,2,14
UTILITY_GUY,23743,4,1,1,6
GREEDY,30584,6,0,1,7
STATION_GUY,47310,8,0,1,9
UTILITY_GUY,36715,5,0,0,5
GREEDY,15830,11,0,3,14
GREEDY,20180,6,1,0,7
GREEDY,29376,10,1,1,12
STATION_GUY,30044,5,0,3,8
DEFAULT,34064,6,0,0,6
GREEDY,34724,7,1,1,9
GREEDY,45915,10,0,0,10
GREEDY,18692,11,0,1,12
GREEDY,15248,8,0,1,9
GREEDY,21034,9,0,3,12
UTILITY_GUY,50267,5,1,1,7
STATION_GUY,36405,6,0,0,6
GREEDY,15047,7,1,0,8
GREEDY,22668,7,1,2,10
STINGY,42410,3,0,0,3
GREEDY,26876,10,0,1,11
GREEDY,16022,8,0,0,8
GREEDY,39039,11,0,2,13
GREEDY,32580,9,1,1,11
UTILITY_GUY,23894,6,1,0,7
UTILITY_GUY,75286,6,0,0,6
GREEDY,24486,8,0,1,9
GREEDY,56988,9,0,1,10
UTILITY_GUY,53916,7,1,0,8
DEFAULT,35154,6,0,0,6
GREEDY,19452,7,1,1,9
DEFAULT,26292,8,0,1,9
GREEDY,24932,9,1,2,12
DEFAULT,23274,2,0,0,2
GREEDY,12144,9,1,3,13
GREEDY,13854,7,2,4,13
UTILITY_GUY,40292,5,0,1,6
UTILITY_GUY,39946,5,1,2,8
GREEDY,19329,9,0,2,11
DEFAULT,63808,6,1,0,7
GREEDY,20135,8,0,1,9
DEFAULT,58491,6,0,0,6
GREEDY,18664,9,1,0,10
GREEDY,17536,9,0,1,10
GREEDY,15358,8,1,2,11
GREEDY,62142,7,1,1,9
GREEDY,17089,9,0,0,9
GREEDY,13525,11,1,1,13
UTILITY_GUY,50936,4,1,0,5
STATION_GUY,24312,8,0,2,10
STATION_GUY,32598,4,0,0,4
GREEDY,38194,8,1,1,10
GREEDY,26256,6,0,1,7
STINGY,80858,5,0,0,5
UTILITY_GUY,38785,3,0,1,4
DEFAULT,34508,8,0,0,8
GREEDY,15199,8,0,0,8
GREEDY,14346,6,0,1,7
STATION_GUY,29395,4,1,1,6
UTILITY_GUY,56980,5,1,1,7
GREEDY,43348,9,0,0,9
GREEDY,22390,12,0,2,14
GREEDY,34896,10,0,0,10
GREEDY,18463,8,0,1,9
UTILITY_GUY,27293,3,2,0,5
GREEDY,47664,9,0,3,12
GREEDY,17830,8,1,0,9
STATION_GUY,24677,7,0,1,8
STINGY,98386,5,0,2,7
GREEDY,43588,8,0,1,9
GREEDY,54565,10,0,2,12
GREEDY,28863,8,0,1,9
GREEDY,28961,9,0,0,9
STATION_GUY,36172,4,0,1,5
GREEDY,14477,10,0,2,12
STATION_GUY,38123,6,0,2,8
DEFAULT,57646,3,2,0,5
GREEDY,70570,10,1,2,13
STATION_GUY,62652,6,0,2,8
GREEDY,16658,11,0,0,11
GREEDY,95863,8,2,1,11
GREEDY,19904,9,0,3,12
DEFAULT,47477,7,1,1,9
GREEDY,22088,10,0,0,10
GREEDY,29151,10,1,2,13
GREEDY,20242,7,0,1,8
GREEDY,16850,11,2,0,13
DEFAULT,39867,6,0,1,7
DEFAULT,18096,4,0,0,4
UTILITY_GUY,66097,4,0,0,4
GREEDY,30110,6,1,0,7
GREEDY,35530,10,0,0,10
GREEDY,17887,14,1,3,18
GREEDY,63171,10,1,1,12
GREEDY,18081,9,0,1,10
GREEDY,9903,9,0,1,10
GREEDY,89748,6,1,0,7
DEFAULT,35899,5,0,0,5
GREEDY,35194,10,0,2,12
GREEDY,23559,6,1,0,7
GREEDY,25259,10,1,0,11
DEFAULT,46530,8,0,2,10
GREEDY,18471,7,1,1,9
GREEDY,10913,9,1,2,12
GREEDY,22086,10,0,2,12
UTILITY_GUY,37471,4,0,2,6
GREEDY,25473,9,0,2,11
GREEDY,9653,9,1,4,14
UTILITY_GUY,15587,5,0,0,5
GREEDY,35569,11,0,1,12
GREEDY,23080,7,2,1,10
GREEDY,31541,8,0,2,10
STATION_GUY,35863,6,0,2,8
GREEDY,43410,8,0,1,9
GREEDY,45387,10,1,0,11
DEFAULT,56473,9,0,0,9
GREEDY,11993,9,0,2,11
GREEDY,25058,11,0,0,11
DEFAULT,39155,7,0,1,8
GREEDY,11779,6,0,1,7
GREEDY,35558,9,0,0,9
STATION_GUY,44713,5,0,2,7
GREEDY,20455,8,0,2,10
GREEDY,15140,10,0,3,13
GREEDY,18819,10,0,2,12
DEFAULT,63497,6,1,2,9
UTILITY_GUY,34593,5,1,1,7
GREEDY,17410,11,0,0,11
STATION_GUY,61516,7,0,0,7
GREEDY,12765,9,0,2,11
UTILITY_GUY,32749,5,0,2,7
GREEDY,30770,10,1,1,12
GREEDY,25490,11,0,2,13
GREEDY,15001,9,1,2,12
GREEDY,33463,9,1,2,12
GREEDY,21179,8,0,2,10
STATION_GUY,82843,7,0,4,11
GREEDY,26489,9,0,0,9
GREEDY,30041,10,0,2,12
GREEDY,24112,7,0,3,10
STATION_GUY,34555,8,0,0,8
DEFAULT,35991,6,0,1,7
GREEDY,9155,9,2,0,11
GREEDY,24111,10,0,3,13
GREEDY,34114,9,0,1,10
GREEDY,20150,8,1,0,9
GREEDY,14847,7,0,3,10
GREEDY,18439,5,0,1,6
STATION_GUY,17988,6,0,0,6
DEFAULT,41083,6,1,0,7
DEFAULT,35133,7,0,1,8
GREEDY,21730,7,1,4,12
DEFAULT,24747,5,0,0,5
DEFAULT,41907,8,0,0,8
GREEDY,18339,10,1,2,13
GREEDY,14928,5,0,0,5
UTILITY_GUY,52154,4,2,0,6
GREEDY,17273,10,1,2,13
DEFAULT,38915,8,1,0,9
DEFAULT,41735,6,0,0,6
UTILITY_GUY,29162,6,1,2,9
GREEDY,12952,9,0,1,10
STATION_GUY,39540,7,0,0,7
GREEDY,61800,12,0,1,13
GREEDY,14267,10,0,0,10
UTILITY_GUY,75847,6,0,0,6
UTILITY_GUY,18844,7,1,1,9
GREEDY,47809,13,1,2,16
GREEDY,10867,6,1,2,9
STATION_GUY,23012,6,0,2,8
STINGY,89487,3,1,0,4
GREEDY,30575,6,1,1,8
GREEDY,25861,10,0,3,13
GREEDY,48403,9,0,1,10
STATION_GUY,35112,7,0,2,9
DEFAULT,36306,5,0,0,5
STATION_GUY,34051,6,0,0,6
DEFAULT,71359,8,0,1,9
STATION_GUY,53046,4,0,1,5
DEFAULT,36769,5,0,0,5
GREEDY,97086,10,1,1,12
GREEDY,27050,5,1,1,7
GREEDY,31345,12,0,1,13
DEFAULT,37041,6,1,0,7
UTILITY_GUY,27062,6,1,1,8
GREEDY,12935,8,1,0,9
GREEDY,25060,8,0,2,10
STATION_GUY,22804,4,0,3,7
GREEDY,22245,9,1,0,10
DEFAULT,43781,8,0,0,8
GREEDY,32578,8,1,1,10
GREEDY,28015,9,0,2,11
GREEDY,22426,7,1,0,8
GREEDY,24096,8,1,1,10
UTILITY_GUY,33613,6,0,0,6
UTILITY_GUY,77087,6,1,2,9
DEFAULT,17524,13,1,2,16
GREEDY,35617,8,0,0,8
GREEDY,22070,9,0,0,9
DEFAULT,70583,7,0,1,8
GREEDY,27993,6,0,1,7
DEFAULT,58395,6,1,1,8
GREEDY,80213,9,0,0,9
STATION_GUY,15484,5,0,0,5
GREEDY,20571,6,1,0,7
GREEDY,32305,9,1,1,11
GREEDY,43202,9,0,0,9
UTILITY_GUY,46852,6,1,1,8
DEFAULT,28606,6,1,0,7
GREEDY,33100,12,1,3,16
GREEDY,14161,9,1,2,12
UTILITY_GUY,97240,6,1,0,7
STATION_GUY,20184,7,0,2,9
GREEDY,20115,10,1,1,12
DEFAULT,73139,5,0,0,5
DEFAULT,11869,4,1,1,6
GREEDY,23783,12,1,2,15
DEFAULT,30738,4,1,2,7
GREEDY,82300,11,0,0,11
GREEDY,24949,7,1,0,8
GREEDY,28255,9,1,1,11
STATION_GUY,36357,3,2,4,9
GREEDY,16647,10,1,0,11
GREEDY,14389,11,1,1,13
GREEDY,23144,11,0,2,13
UTILITY_GUY,15095,5,1,1,7
GREEDY,18785,6,0,3,9
STATION_GUY,61276,5,0,1,6
GREEDY,23757,8,0,0,8
STATION_GUY,25853,6,0,1,7
GREEDY,22722,6,0,1,7
GREEDY,44856,11,0,1,12
GREEDY,19577,7,0,3,10
GREEDY,21155,10,0,2,12
GREEDY,10713,10,0,2,12
UTILITY_GUY,22539,8,1,0,9
UTILITY_GUY,38958,5,1,1,7
GREEDY,24016,8,0,2,10
GREEDY,19682,9,0,1,10
GREEDY,29770,7,1,2,10
DEFAULT,52165,6,0,1,7
GREEDY,17734,6,1,3,10
GREEDY,16352,6,0,2,8
STATION_GUY,27036,2,0,1,3
GREEDY,17774,8,1,1,10
DEFAULT,19196,5,0,0,5
STATION_GUY,44006,2,0,0,2
STATION_GUY,32655,4,0,1,5
GREEDY,23520,7,0,1,8
DEFAULT,77897,5,0,1,6
GREEDY,22213,5,1,3,9
DEFAULT,39755,7,0,1,8
GREEDY,26232,10,0,1,11
DEFAULT,59466,8,0,2,10
UTILITY_GUY,25657,7,1,1,9
GREEDY,48799,9,0,0,9
STATION_GUY,30995,6,0,4,10
UTILITY_GUY,51346,7,0,0,7
DEFAULT,23229,6,1,2,9
GREEDY,22184,10,1,2,13
DEFAULT,22368,4,0,0,4
GREEDY,33909,6,0,1,7
GREEDY,15472,8,0,2,10
DEFAULT,62321,10,0,0,10
STATION_GUY,23273,4,0,1,5
STATION_GUY,61956,6,0,1,7
DEFAULT,88807,5,1,1,7
GREEDY,27331,9,2,2,13
STATION_GUY,47810,9,0,1,10
GREEDY,22589,7,1,0,8
DEFAULT,35075,6,1,1,8
GREEDY,24886,8,0,0,8
GREEDY,63332,7,2,4,13
GREEDY,20409,8,1,2,11
STATION_GUY,69621,5,0,1,6
STATION_GUY,46833,6,1,3,10
DEFAULT,54499,5,0,0,5
DEFAULT,48961,5,0,1,6
GREEDY,25124,7,0,2,9
STATION_GUY,50164,4,0,4,8
DEFAULT,47363,7,0,1,8
STATION_GUY,40800,4,0,4,8
DEFAULT,22760,8,0,0,8
STATION_GUY,32493,6,0,3,9
STATION_GUY,29952,4,1,4,9
GREEDY,43929,5,1,3,9
GREEDY,19764,7,1,1,9
DEFAULT,39620,7,1,1,9
DEFAULT,32496,5,0,1,6
GREEDY,26411,7,1,1,9
UTILITY_GUY,89065,6,1,1,8
UTILITY_GUY,37960,7,1,0,8
GREEDY,19013,9,1,1,11
STATION_GUY,47945,5,0,2,7
GREEDY,17513,9,0,0,9
GREEDY,21459,9,0,1,10
GREEDY,18832,5,1,1,7
UTILITY_GUY,38203,6,1,1,8
GREEDY,25654,10,0,0,10
GREEDY,20350,7,0,2,9
DEFAULT,44297,7,0,1,8
GREEDY,20767,10,1,2,13
GREEDY,21333,8,2,2,12
STATION_GUY,29170,3,1,1,5
GREEDY,15270,10,0,2,12
DEFAULT,78822,7,0,0,7
GREEDY,30197,8,1,1,10
GREEDY,16438,4,1,4,9
GREEDY,25461,10,0,0,10
GREEDY,19960,9,0,1,10
GREEDY,20442,9,1,2,12
DEFAULT,20583,4,1,1,6
GREEDY,28769,9,1,1,11
GREEDY,21169,8,0,1,9
GREEDY,17424,9,1,1,11
UTILITY_GUY,38161,7,0,0,7
GREEDY,35962,9,0,2,11
GREEDY,13215,6,0,3,9
GREEDY,20174,8,0,0,8
STATION_GUY,24676,4,0,1,5
UTILITY_GUY,31131,4,1,1,6
GREEDY,17034,8,0,0,8
GREEDY,13224,7,0,1,8
GREEDY,18658,10,1,0,11
GREEDY,21321,12,0,1,13
DEFAULT,51748,9,0,0,9
DEFAULT,50362,6,0,0,6
GREEDY,26123,8,2,1,11
UTILITY_GUY,33352,4,0,1,5
GREEDY,75334,9,0,1,10
GREEDY,52694,5,1,2,8
GREEDY,19361,11,2,1,14
UTILITY_GUY,44831,6,1,0,7
DEFAULT,43370,8,1,0,9
GREEDY,30641,6,0,2,8
GREEDY,29037,8,0,0,8
GREEDY,11434,10,0,1,11
UTILITY_GUY,28139,8,0,0,8
DEFAULT,54017,7,1,1,9
GREEDY,26234,6,0,1,7
DEFAULT,32414,3,1,1,5
GREEDY,16907,13,1,2,16
GREEDY,26899,7,1,1,9
GREEDY,10791,9,0,1,10
GREEDY,16785,8,0,1,9
STATION_GUY,41397,9,1,1,11
DEFAULT,36815,7,1,1,9
GREEDY,36621,11,0,0,11
GREEDY,32629,10,0,1,11
GREEDY,12636,6,0,2,8
STATION_GUY,25801,8,0,1,9
GREEDY,51221,8,0,2,10
GREEDY,21911,7,0,1,8
UTILITY_GUY,42037,7,1,0,8
STATION_GUY,39017,7,0,2,9
GREEDY,15617,11,0,1,12
GREEDY,20276,6,1,1,8
UTILITY_GUY,44097,5,0,0,5
GREEDY,23378,10,1,0,11
UTILITY_GUY,38623,3,1,1,5
GREEDY,15701,7,0,1,8
STATION_GUY,61267,5,0,1,6
DEFAULT,53598,7,0,1,8
GREEDY,37639,8,0,1,9
GREEDY,20589,9,0,2,11
STATION_GUY,61111,7,0,1,8
DEFAULT,23981,6,0,1,7
GREEDY,15206,7,0,1,8
GREEDY,25243,10,0,1,11
GREEDY,20189,7,0,1,8
DEFAULT,21951,8,0,1,9
GREEDY,19577,8,0,0,8
DEFAULT,22575,9,0,1,10
STATION_GUY,51560,4,1,4,9
UTILITY_GUY,18116,4,0,0,4
GREEDY,31597,8,1,1,10
UTILITY_GUY,63162,6,1,0,7
GREEDY,15506,10,1,2,13
GREEDY,13560,10,0,0,10
GREEDY,20810,11,1,0,12
GREEDY,21499,9,1,0,10
DEFAULT,57663,7,0,0,7
STATION_GUY,38550,6,2,3,11
STATION_GUY,56064,6,0,0,6
GREEDY,27075,7,0,0,7
STATION_GUY,73040,8,0,0,8
UTILITY_GUY,23163,3,0,0,3
DEFAULT,34307,7,0,0,7
GREEDY,20325,8,1,1,10
GREEDY,14614,7,1,2,10
STATION_GUY,42358,5,1,2,8
GREEDY,19395,6,1,2,9
DEFAULT,48370,6,1,0,7
DEFAULT,28418,5,0,0,5
GREEDY,23195,6,0,1,7
GREEDY,28433,6,1,0,7
STATION_GUY,41219,5,1,1,7
STATION_GUY,38073,5,0,3,8
GREEDY,16733,12,0,3,15
GREEDY,10349,8,1,1,10
GREEDY,70308,11,0,1,12
STATION_GUY,31314,5,0,2,7
GREEDY,20317,10,0,1,11
GREEDY,19356,7,0,1,8
GREEDY,23834,11,1,1,13
GREEDY,14639,7,1,2,10
GREEDY,23609,11,0,1,12
GREEDY,13051,8,1,0,9
DEFAULT,76241,7,0,0,7
DEFAULT,26216,9,0,2,11
GREEDY,18497,9,1,0,10
GREEDY,14166,7,1,1,9
GREEDY,21516,6,1,2,9
GREEDY,26768,10,1,1,12
DEFAULT,58176,7,0,1,8
GREEDY,21520,7,0,0,7
GREEDY,17411,6,0,0,6
GREEDY,16636,8,0,1,9
STATION_GUY,39242,5,0,1,6
DEFAULT,37740,6,1,0,7
GREEDY,14215,9,1,0,10
DEFAULT,27542,8,0,0,8
GREEDY,18619,9,1,1,11
DEFAULT,36922,6,0,0,6
GREEDY,26545,8,0,0,8
GREEDY,28822,7,2,2,11
GREEDY,26816,9,1,1,11
GREEDY,26078,10,0,1,11
GREEDY,17507,8,1,0,9
DEFAULT,52685,8,0,0,8
DEFAULT,84324,7,0,0,7
GREEDY,31540,7,0,0,7
GREEDY,17732,10,0,2,12
DEFAULT,65917,8,0,2,10
GREEDY,16170,10,1,0,11
GREEDY,17508,8,0,1,9
GREEDY,22007,8,1,3,12
GREEDY,63712,11,1,1,13
GREEDY,21433,8,0,1,9
STATION_GUY,28120,5,0,3,8
DEFAULT,68415,5,0,0,5
GREEDY,25013,6,2,2,10
GREEDY,23448,7,1,1,9
DEFAULT,74914,9,0,0,9
GREEDY,26595,8,0,0,8
GREEDY,20758,10,1,2,13
UTILITY_GUY,49181,5,1,1,7
GREEDY,45510,11,2,0,13
GREEDY,22597,9,0,1,10
STATION_GUY,43296,4,1,2,7
UTILITY_GUY,64085,4,0,1,5
GREEDY,27093,11,1,1,13
STATION_GUY,48789,7,0,1,8
GREEDY,47468,6,2,1,9
DEFAULT,35961,6,1,1,8
GREEDY,17790,7,1,1,9
DEFAULT,38096,7,1,0,8
GREEDY,32997,8,0,0,8
GREEDY,23386,13,0,0,13
UTILITY_GUY,88475,5,0,0,5
DEFAULT,24007,7,0,3,10
GREEDY,13851,7,1,0,8
GREEDY,23776,11,0,1,12
GREEDY,25134,9,0,1,10
STATION_GUY,70840,4,0,2,6
UTILITY_GUY,44441,4,1,1,6
UTILITY_GUY,75770,4,0,0,4
GREEDY,18468,10,0,1,11
GREEDY,16253,8,1,0,9
GREEDY,15339,9,0,0,9
UTILITY_GUY,69542,6,1,0,7
UTILITY_GUY,13788,5,0,1,6
STATION_GUY,75399,7,1,3,11
GREEDY,23292,6,0,2,8
GREEDY,63601,4,0,3,7
UTILITY_GUY,32922,5,0,1,6
DEFAULT,33761,9,0,0,9
GREEDY,29625,10,1,0,11
GREEDY,20553,9,0,1,10
GREEDY,23988,9,1,3,13
STATION_GUY,20097,5,1,2,8
GREEDY,32967,10,1,1,12
GREEDY,10654,8,0,0,8
UTILITY_GUY,50506,5,1,0,6
GREEDY,62197,11,0,1,12
GREEDY,36308,9,1,1,11
GREEDY,48717,11,0,0,11
UTILITY_GUY,33293,6,0,1,7
STATION_GUY,35170,5,0,0,5
GREEDY,33834,7,1,3,11
STATION_GUY,23558,7,0,2,9
GREEDY,28139,8,0,0,8
DEFAULT,33587,9,1,0,10
DEFAULT,62480,7,1,0,8
GREEDY,15626,9,1,1,11
DEFAULT,9290,7,1,0,8
UTILITY_GUY,32863,5,1,0,6
GREEDY,24504,8,0,1,9
STATION_GUY,57368,7,0,1,8
GREEDY,46114,7,1,1,9
STATION_GUY,87411,7,1,0,8
GREEDY,25090,8,0,1,9
GREEDY,39649,8,1,2,11
UTILITY_GUY,35223,4,1,0,5
GREEDY,20684,7,1,0,8
DEFAULT,33531,7,0,2,9
STATION_GUY,44752,7,0,1,8
UTILITY_GUY,35626,5,1,0,6
DEFAULT,51292,7,1,0,8
DEFAULT,32943,10,0,0,10
STATION_GUY,22258,5,0,4,9
DEFAULT,49106,7,0,0,7
STATION_GUY,56848,5,0,4,9
UTILITY_GUY,33410,4,1,2,7
GREEDY,23680,6,1,2,9
GREEDY,31538,9,1,2,12
GREEDY,19761,7,1,1,9
DEFAULT,50095,9,0,0,9
UTILITY_GUY,89692,9,2,0,11
DEFAULT,34344,8,0,1,9
STATION_GUY,44620,6,0,0,6
GREEDY,33586,8,2,1,11
STATION_GUY,14758,3,1,3,7
STATION_GUY,43460,7,0,1,8
UTILITY_GUY,65051,8,0,0,8
GREEDY,26661,11,0,1,12
GREEDY,51186,5,1,4,10
GREEDY,39150,10,1,1,12
GREEDY,13613,9,0,0,9
GREEDY,35700,11,0,0,11
GREEDY,23972,9,0,1,10
GREEDY,26533,8,1,1,10
DEFAULT,87334,3,1,0,4
GREEDY,76999,9,1,1,11
GREEDY,18488,9,0,2,11
GREEDY,17702,9,1,0,10
STATION_GUY,77627,8,0,1,9
STATION_GUY,16624,5,0,1,6
GREEDY,21362,7,1,0,8
GREEDY,34139,7,0,2,9
STINGY,82985,3,0,0,3
DEFAULT,95418,7,1,1,9
GREEDY,78486,8,1,2,11
GREEDY,29678,6,1,2,9
DEFAULT,67523,7,0,0,7
UTILITY_GUY,46381,7,1,0,8
UTILITY_GUY,43339,4,0,0,4
GREEDY,29971,9,1,0,10
STATION_GUY,22444,8,0,2,10
GREEDY,18811,10,1,0,11
UTILITY_GUY,69915,4,1,0,5
STATION_GUY,64309,5,0,2,7
DEFAULT,51355,8,1,0,9
STATION_GUY,85315,4,0,0,4
UTILITY_GUY,33983,8,2,1,11
UTILITY_GUY,85492,8,0,0,8
GREEDY,15565,6,0,1,7
STATION_GUY,45994,6,0,0,6
STATION_GUY,36424,7,0,0,7
GREEDY,37805,9,0,1,10
UTILITY_GUY,33184,9,0,0,9
GREEDY,46743,9,1,2,12
GREEDY,13516,9,1,1,11
DEFAULT,53118,6,0,0,6
GREEDY,16661,7,0,1,8
DEFAULT,76971,8,0,0,8
UTILITY_GUY,42208,2,2,1,5
GREEDY,27162,9,0,0,9
GREEDY,37664,12,0,1,13
DEFAULT,16167,9,0,0,9
GREEDY,20757,8,1,0,9
GREEDY,34821,8,0,1,9
DEFAULT,46392,2,0,2,4
GREEDY,23830,8,0,0,8
GREEDY,13776,11,1,0,12
GREEDY,91012,9,0,1,10
GREEDY,30541,14,0,0,14
GREEDY,34040,10,0,2,12
GREEDY,26478,9,0,3,12
UTILITY_GUY,42037,4,0,1,5
GREEDY,18433,11,0,1,12
STATION_GUY,47231,4,0,2,6
GREEDY,17366,6,0,1,7
GREEDY,29999,7,1,2,10
GREEDY,15984,7,0,0,7
GREEDY,39487,10,0,3,13
STATION_GUY,57637,4,1,0,5
STATION_GUY,33579,3,0,4,7
DEFAULT,22422,6,1,1,8
DEFAULT,39310,5,1,1,7
GREEDY,22485,7,2,2,11
DEFAULT,50881,7,1,0,8
DEFAULT,25701,7,0,1,8
GREEDY,71891,9,0,1,10
GREEDY,56905,9,0,1,10
GREEDY,9855,9,0,0,9
DEFAULT,18834,5,0,1,6
UTILITY_GUY,63198,8,1,1,10
GREEDY,15936,7,1,1,9
GREEDY,14661,7,2,2,11
GREEDY,28427,11,0,1,12
GREEDY,16781,9,1,2,12
GREEDY,23586,9,1,1,11
GREEDY,12888,7,0,3,10
GREEDY,27804,9,1,2,12
DEFAULT,59970,5,0,1,6
STATION_GUY,53587,7,0,1,8
STATION_GUY,37534,6,0,0,6
DEFAULT,25411,7,0,0,7
DEFAULT,50499,5,1,1,7
GREEDY,14923,12,1,1,14
GREEDY,32700,9,1,1,11
GREEDY,23752,8,0,1,9
GREEDY,25284,11,0,1,12
GREEDY,33420,8,0,1,9
UTILITY_GUY,65817,4,0,0,4
DEFAULT,27160,6,1,1,8
DEFAULT,16357,7,0,1,8
GREEDY,18376,7,0,1,8
GREEDY,26923,9,0,2,11
GREEDY,51245,8,0,1,9
DEFAULT,37267,10,0,1,11
GREEDY,36049,8,0,1,9
DEFAULT,51534,8,0,1,9
GREEDY,21703,7,1,1,9
STATION_GUY,40628,9,0,2,11
GREEDY,26256,8,1,2,11
STATION_GUY,34641,6,0,2,8
DEFAULT,85999,7,0,0,7
GREEDY,25154,11,1,1,13
STATION_GUY,18252,6,0,1,7
GREEDY,34888,9,0,1,10
GREEDY,22493,9,1,1,11
GREEDY,27358,7,1,0,8
GREEDY,18922,9,1,0,10
STATION_GUY,29563,6,0,1,7
GREEDY,61661,12,0,1,13
DEFAULT,97300,8,0,0,8
UTILITY_GUY,83891,4,1,0,5
UTILITY_GUY,41847,4,1,0,5
UTILITY_GUY,63960,7,0,1,8
GREEDY,20017,6,0,2,8
DEFAULT,38417,7,0,0,7
GREEDY,24130,8,2,1,11
GREEDY,30549,8,1,2,11
GREEDY,49917,7,1,4,12
GREEDY,29061,9,1,0,10
GREEDY,20783,10,0,1,11
GREEDY,19254,10,0,1,11
GREEDY,15775,9,1,3,13
GREEDY,10691,10,1,0,11
DEFAULT,34857,4,0,3,7
UTILITY_GUY,24370,5,0,0,5
DEFAULT,68430,7,1,0,8
STATION_GUY,36108,8,0,3,11
GREEDY,33337,10,1,1,12
GREEDY,40994,7,0,0,7
GREEDY,17410,10,0,1,11
GREEDY,22765,10,0,2,12
STATION_GUY,41133,5,1,2,8
GREEDY,14579,7,0,2,9
GREEDY,18742,7,0,0,7
STATION_GUY,43249,6,0,1,7
GREEDY,28707,10,0,1,11
UTILITY_GUY,54299,4,1,0,5
GREEDY,25456,11,0,0,11
GREEDY,13986,7,0,0,7
GREEDY,24543,7,0,0,7
GREEDY,18845,4,1,0,5
GREEDY,18472,6,1,1,8
UTILITY_GUY,30189,4,1,1,6
GREEDY,16668,12,0,1,13
STATION_GUY,28153,4,0,2,6
DEFAULT,61804,6,0,0,6
GREEDY,20697,9,0,1,10
DEFAULT,53418,9,0,2,11
GREEDY,37190,11,0,1,12
DEFAULT,57087,6,1,0,7
STATION_GUY,37780,3,0,1,4
DEFAULT,41581,8,1,0,9
GREEDY,30120,13,0,0,13
GREEDY,34774,11,0,3,14
UTILITY_GUY,44608,6,0,1,7
DEFAULT,29674,6,0,1,7
GREEDY,23148,8,1,1,10
GREEDY,66208,10,1,1,12
GREEDY,33676,8,0,0,8
DEFAULT,32390,8,0,1,9
GREEDY,68049,10,0,2,12
STATION_GUY,66029,5,0,2,7
DEFAULT,37011,9,0,0,9
GREEDY,16349,9,1,2,12
GREEDY,59433,10,2,1,13
GREEDY,26023,6,0,1,7
GREEDY,38958,12,0,1,13
DEFAULT,84821,7,1,0,8
DEFAULT,48065,4,1,1,6
STATION_GUY,38127,6,0,0,6
STATION_GUY,24552,3,0,1,4
DEFAULT,74780,7,0,1,8
GREEDY,16232,7,0,1,8
UTILITY_GUY,41608,5,0,0,5
GREEDY,13773,7,1,0,8
GREEDY,20634,10,1,0,11
STATION_GUY,34321,4,0,1,5
UTILITY_GUY,44248,3,1,2,6
GREEDY,19469,9,0,0,9
GREEDY,25085,11,0,1,12
GREEDY,37738,10,1,1,12
STATION_GUY,30179,5,1,1,7
STATION_GUY,24366,3,0,0,3
GREEDY,21832,7,0,3,10
GREEDY,23822,12,0,2,14
GREEDY,16279,11,0,1,12
STINGY,78792,6,0,0,6
DEFAULT,21198,4,0,1,5
GREEDY,16478,8,0,1,9
DEFAULT,38561,7,0,0,7
GREEDY,13400,9,0,4,13
GREEDY,36999,7,0,1,8
GREEDY,19202,7,0,2,9
GREEDY,65695,7,0,4,11
GREEDY,51120,10,0,3,13
GREEDY,47873,12,1,0,13
GREEDY,52554,8,0,2,10
GREEDY,16037,8,0,2,10
DEFAULT,56578,7,1,0,8
UTILITY_GUY,14728,3,1,4,8
GREEDY,21646,9,1,1,11
STATION_GUY,63470,8,0,0,8
STATION_GUY,41227,5,0,1,6
GREEDY,46717,10,0,2,12
UTILITY_GUY,24615,5,1,0,6
GREEDY,13856,9,1,0,10
GREEDY,64670,7,1,2,10
STATION_GUY,62185,5,0,3,8
GREEDY,19457,5,2,0,7
DEFAULT,71599,9,0,1,10
STATION_GUY,32794,5,0,1,6
GREEDY,14138,9,0,1,10
GREEDY,20913,8,0,1,9
GREEDY,41262,7,0,0,7
DEFAULT,46286,5,1,0,6
DEFAULT,43426,9,0,0,9
GREEDY,20740,7,0,0,7
UTILITY_GUY,92454,6,0,1,7
GREEDY,29265,5,1,0,6
GREEDY,19180,10,1,0,11
GREEDY,25623,8,1,2,11
GREEDY,58493,5,0,2,7
GREEDY,11633,6,1,1,8
STATION_GUY,34089,7,0,1,8
GREEDY,34611,8,0,1,9
DEFAULT,34858,8,0,0,8
GREEDY,31455,7,0,0,7
GREEDY,25015,8,0,1,9
UTILITY_GUY,40822,7,0,0,7
GREEDY,58476,10,0,1,11
DEFAULT,76831,6,0,0,6
GREEDY,14401,8,2,1,11
GREEDY,36158,10,0,1,11
STATION_GUY,23989,4,1,0,5
GREEDY,17137,7,0,0,7
DEFAULT,89554,8,0,0,8
GREEDY,8233,6,2,2,10
DEFAULT,38734,7,0,0,7
UTILITY_GUY,48894,6,0,1,7
GREEDY,16159,12,0,2,14
STATION_GUY,17198,5,0,4,9
GREEDY,20645,9,1,1,11
STATION_GUY,93948,8,1,2,11
DEFAULT,21319,6,1,0,7
DEFAULT,81012,7,0,1,8
GREEDY,15836,11,0,0,11
GREEDY,20707,9,0,2,11
DEFAULT,68320,7,0,0,7
GREEDY,20438,5,1,1,7
GREEDY,23554,11,1,0,12
GREEDY,17295,9,1,2,12
GREEDY,18653,6,1,2,9
DEFAULT,51600,6,0,0,6
STATION_GUY,38664,2,0,1,3
GREEDY,18594,8,1,0,9
DEFAULT,44810,7,0,0,7
GREEDY,24752,7,1,1,9
GREEDY,19563,9,1,0,10
DEFAULT,40879,6,0,1,7
DEFAULT,56875,6,0,2,8
GREEDY,40465,8,0,3,11
GREEDY,17992,9,0,0,9
DEFAULT,91453,6,1,1,8
UTILITY_GUY,24802,6,2,1,9
GREEDY,10250,9,1,1,11
GREEDY,26954,5,0,1,6
UTILITY_GUY,75977,9,1,0,10
GREEDY,19237,11,1,2,14
GREEDY,12173,8,0,3,11
DEFAULT,18743,7,1,0,8
GREEDY,28437,7,0,1,8
GREEDY,18228,9,1,1,11
STATION_GUY,32864,5,0,1,6
GREEDY,19623,7,0,1,8
DEFAULT,45448,7,0,1,8
GREEDY,22326,9,0,1,10
GREEDY,19739,7,0,0,7
GREEDY,24089,8,0,2,10
GREEDY,32187,9,1,1,11
GREEDY,27132,9,2,2,13
GREEDY,56815,10,0,1,11
GREEDY,14663,11,0,1,12
DEFAULT,53440,7,2,1,10
STATION_GUY,22836,4,0,0,4
STATION_GUY,74078,6,0,1,7
GREEDY,23225,10,1,1,12
DEFAULT,41053,5,1,1,7
GREEDY,18697,8,0,1,9
STATION_GUY,42954,3,0,2,5
GREEDY,17351,9,0,1,10
DEFAULT,26730,5,0,3,8
GREEDY,14485,7,1,2,10
GREEDY,70804,8,1,1,10
GREEDY,21367,11,0,0,11
GREEDY,18463,7,2,2,11
UTILITY_GUY,76828,4,2,0,6
GREEDY,20448,9,1,4,14
UTILITY_GUY,47898,4,0,0,4
GREEDY,21651,9,0,1,10
GREEDY,17410,11,1,2,14
DEFAULT,52930,7,1,0,8
GREEDY,55822,11,0,1,12
DEFAULT,59262,7,1,0,8
GREEDY,17894,8,1,0,9
UTILITY_GUY,36058,4,0,0,4
STATION_GUY,8210,6,0,1,7
DEFAULT,40306,7,1,1,9
GREEDY,22128,5,0,0,5
GREEDY,25806,7,0,1,8
DEFAULT,57794,7,1,1,9
UTILITY_GUY,16292,9,1,0,10
UTILITY_GUY,48207,8,2,0,10
STATION_GUY,55218,6,0,2,8
GREEDY,21319,8,2,1,11
DEFAULT,43870,11,0,1,12
GREEDY,80947,8,0,1,9
DEFAULT,54978,8,1,0,9
GREEDY,16706,8,1,3,12
DEFAULT,47941,4,0,1,5
GREEDY,41795,9,1,2,12
GREEDY,35821,7,0,0,7
GREEDY,21354,8,1,3,12
GREEDY,14769,9,0,1,10
GREEDY,77864,6,0,3,9
GREEDY,20852,7,0,1,8
GREEDY,90943,8,0,0,8
STATION_GUY,40959,7,0,1,8
STATION_GUY,57462,3,0,1,4
DEFAULT,28297,6,0,1,7
GREEDY,16333,5,1,1,7
STATION_GUY,30969,5,0,2,7
GREEDY,16176,9,0,2,11
GREEDY,23213,8,0,1,9
DEFAULT,18773,11,0,0,11
GREEDY,23497,11,0,1,12
GREEDY,14464,9,0,2,11
GREEDY,88762,7,0,2,9
GREEDY,24186,9,0,0,9
GREEDY,17636,8,1,1,10
DEFAULT,41805,7,0,1,8
STATION_GUY,53112,5,1,1,7
DEFAULT,35926,6,0,0,6
GREEDY,20059,8,0,2,10
GREEDY,37835,9,0,1,10
GREEDY,21692,8,0,2,10
DEFAULT,19270,6,2,0,8
GREEDY,20854,10,0,1,11
GREEDY,25328,9,0,1,10
GREEDY,14294,7,0,1,8
DEFAULT,60984,8,0,1,9
STATION_GUY,73303,6,0,0,6
GREEDY,26660,6,2,1,9
GREEDY,16863,5,1,2,8
STATION_GUY,37064,7,0,0,7
UTILITY_GUY,38055,8,1,0,9
DEFAULT,20592,4,0,0,4
DEFAULT,33041,7,0,0,7
GREEDY,33894,10,1,1,12
STATION_GUY,31402,4,0,2,6
GREEDY,27394,9,0,1,10
GREEDY,20926,9,0,0,9
UTILITY_GUY,14280,7,0,0,7
UTILITY_GUY,96753,5,1,1,7
GREEDY,39754,11,0,0,11
GREEDY,14831,8,0,1,9
GREEDY,33819,8,0,2,10
GREEDY,60805,9,0,0,9
UTILITY_GUY,43260,8,0,0,8
UTILITY_GUY,95062,7,1,0,8
STATION_GUY,17132,7,0,1,8
UTILITY_GUY,25143,3,1,1,5
STINGY,91133,2,0,0,2
GREEDY,31104,6,0,2,8
UTILITY_GUY,34102,6,1,0,7
GREEDY,37178,7,0,0,7
GREEDY,27944,7,1,1,9
DEFAULT,54321,5,0,0,5
STATION_GUY,18288,7,1,2,10
STATION_GUY,93216,6,0,1,7
GREEDY,22985,8,0,0,8
GREEDY,18084,10,0,0,10
UTILITY_GUY,36180,8,0,1,9
GREEDY,46905,8,1,0,9
GREEDY,65166,7,0,1,8
GREEDY,31140,6,0,1,7
DEFAULT,42685,4,0,1,5
GREEDY,14663,8,1,0,9
GREEDY,19789,7,1,1,9
GREEDY,18942,9,0,0,9
GREEDY,18713,7,0,2,9
GREEDY,55623,6,0,1,7
GREEDY,22869,11,1,2,14
