strategy,money,countries,utilities,stations,totalLandsOwned
,,,,
,,,,
,,,,
,,,,
,,,,
,,,,
UTILITY_GUY,31307,5,1,0,6
GREEDY,12254,8,0,3,11
,,,,
DEFAULT,33709,8,0,0,8
STATION_GUY,24782,5,0,1,6
GREEDY,84041,6,0,2,8
GREEDY,17897,8,1,1,10
GREEDY,38348,8,1,1,10
GREEDY,9598,9,2,2,13
,,,,
,,,,
,,,,
,,,,
,,,,
,,,,
STATION_GUY,33566,4,0,0,4
GREEDY,19265,8,0,3,11
,,,,
,,,,
,,,,
,,,,
,,,,
DEFAULT,41662,8,1,1,10
DEFAULT,67934,7,1,2,10
GREEDY,16858,10,0,0,10
,,,,
,,,,
,,,,
,,,,
,,,,
,,,,
,,,,
,,,,
GREEDY,20187,9,2,2,13
,,,,
,,,,
,,,,
,,,,
,,,,
STATION_GUY,72909,6,1,2,9
GREEDY,21381,4,0,1,5
,,,,
,,,,
,,,,
DEFAULT,55089,7,0,0,7
,,,,
,,,,
STATION_GUY,72737,7,0,2,9
,,,,
STATION_GUY,39458,5,1,0,6
GREEDY,15227,7,1,1,9
GREEDY,97063,8,0,1,9
,,,,
,,,,
,,,,
,,,,
,,,,
DEFAULT,67410,6,1,0,7
GREEDY,17372,8,1,1,10
,,,,
DEFAULT,49605,7,0,1,8
,,,,
,,,,
DEFAULT,65411,8,0,0,8
,,,,
,,,,
GREEDY,26142,5,0,2,7
DEFAULT,40920,5,0,0,5
,,,,
,,,,
DEFAULT,40771,6,0,3,9
,,,,
DEFAULT,43546,6,0,1,7
,,,,
GREEDY,86255,10,1,0,11
,,,,
,,,,
,,,,
,,,,
GREEDY,12911,6,1,2,9
,,,,
,,,,
,,,,
GREEDY,37123,9,0,1,10
,,,,
,,,,
,,,,
DEFAULT,34803,6,1,0,7
,,,,
GREEDY,27827,8,0,2,10
,,,,
,,,,
,,,,
,,,,
