strategy,money,countries,utilities,stations,totalLandsOwned
GREEDY,57574,10,0,0,10
,,,,
UTILITY_GUY,46810,7,1,1,9
,,,,
UTILITY_GUY,68248,5,1,0,6
DEFAULT,39897,9,0,1,10
,,,,
,,,,
,,,,
DEFAULT,25080,5,1,0,6
GREEDY,20503,8,2,1,11
,,,,
,,,,
,,,,
,,,,
,,,,
STATION_GUY,84424,5,0,4,9
,,,,
,,,,
GREEDY,16768,10,1,1,12
,,,,
GREEDY,29058,7,0,0,7
UTILITY_GUY,39996,4,1,1,6
,,,,
STINGY,84445,4,0,0,4
DEFAULT,46723,8,0,0,8
GREEDY,23946,10,0,1,11
STATION_GUY,26460,4,0,2,6
,,,,
,,,,
,,,,
,,,,
DEFAULT,85374,6,1,1,8
DEFAULT,21754,6,0,2,8
,,,,
,,,,
,,,,
GREEDY,19845,9,1,2,12
,,,,
,,,,
,,,,
STATION_GUY,56007,3,0,3,6
GREEDY,80849,10,2,1,13
,,,,
,,,,
GREEDY,18833,8,0,2,10
,,,,
,,,,
,,,,
,,,,
GREEDY,16575,9,1,2,12
,,,,
UTILITY_GUY,49827,7,0,0,7
,,,,
,,,,
GREEDY,28085,9,2,0,11
,,,,
,,,,
,,,,
,,,,
STATION_GUY,24365,6,0,2,8
,,,,
,,,,
,,,,
GREEDY,26614,10,2,2,14
,,,,
GREEDY,14278,7,0,0,7
,,,,
UTILITY_GUY,37582,4,0,0,4
GREEDY,42993,9,1,2,12
GREEDY,20430,8,2,2,12
,,,,
DEFAULT,76459,6,0,1,7
,,,,
,,,,
,,,,
,,,,
,,,,
,,,,
DEFAULT,21087,7,0,1,8
,,,,
,,,,
,,,,
,,,,
,,,,
DEFAULT,65324,7,1,1,9
,,,,
,,,,
,,,,
,,,,
GREEDY,58521,8,0,0,8
UTILITY_GUY,25466,4,2,1,7
,,,,
,,,,
,,,,
,,,,
UTILITY_GUY,23406,7,1,1,9
GREEDY,32223,8,0,1,9
DEFAULT,18509,8,0,1,9
,,,,
