strategy,money,countries,utilities,stations,totalLandsOwned
,,,,
,,,,
,,,,
DEFAULT,16746,5,0,1,6
,,,,
,,,,
GREEDY,19186,8,0,1,9
,,,,
GREEDY,18068,9,0,0,9
,,,,
,,,,
DEFAULT,83817,6,1,1,8
,,,,
,,,,
,,,,
,,,,
,,,,
,,,,
,,,,
GREEDY,14637,8,2,0,10
,,,,
,,,,
,,,,
,,,,
,,,,
,,,,
DEFAULT,63322,8,1,1,10
GREEDY,39183,8,1,2,11
UTILITY_GUY,52468,9,1,0,10
,,,,
,,,,
,,,,
GREEDY,23840,9,1,2,12
DEFAULT,66157,7,1,0,8
STATION_GUY,33460,8,0,3,11
,,,,
,,,,
,,,,
,,,,
,,,,
,,,,
GREEDY,14792,9,1,0,10
,,,,
STATION_GUY,62877,5,0,2,7
GREEDY,21134,10,1,0,11
,,,,
,,,,
GREEDY,39498,10,0,1,11
,,,,
,,,,
,,,,
GREEDY,28480,9,1,0,10
GREEDY,10577,7,0,2,9
,,,,
,,,,
,,,,
GREEDY,28525,9,0,0,9
,,,,
GREEDY,17115,5,1,1,7
,,,,
,,,,
GREEDY,28766,12,0,1,13
,,,,
,,,,
,,,,
,,,,
,,,,
,,,,
GREEDY,18333,9,0,2,11
,,,,
DEFAULT,25219,7,0,0,7
,,,,
,,,,
STATION_GUY,90429,6,1,4,11
,,,,
,,,,
GREEDY,41993,10,0,1,11
GREEDY,11289,9,2,1,12
GREEDY,66951,8,2,1,11
GREEDY,47448,11,1,1,13
DEFAULT,34448,7,0,1,8
,,,,
,,,,
,,,,
,,,,
,,,,
GREEDY,27897,8,0,2,10
,,,,
,,,,
,,,,
,,,,
,,,,
,,,,
,,,,
GREEDY,27880,8,0,1,9
,,,,
,,,,
,,,,
STATION_GUY,28514,4,0,1,5
GREEDY,41642,9,1,0,10
GREEDY,28510,9,1,1,11
,,,,
,,,,
,,,,
GREEDY,24200,11,1,2,14
UTILITY_GUY,39474,5,1,0,6
,,,,
,,,,
,,,,
,,,,
UTILITY_GUY,44015,4,0,0,4
,,,,
,,,,
,,,,
UTILITY_GUY,36526,5,0,0,5
,,,,
,,,,
GREEDY,27107,11,2,1,14
,,,,
,,,,
,,,,
,,,,
,,,,
,,,,
,,,,
STATION_GUY,21367,7,0,1,8
GREEDY,93384,11,0,2,13
GREEDY,35241,9,0,2,11
,,,,
GREEDY,13927,4,1,2,7
DEFAULT,74393,9,0,1,10
,,,,
,,,,
,,,,
DEFAULT,46714,7,0,0,7
,,,,
,,,,
GREEDY,22305,8,0,1,9
,,,,
,,,,
,,,,
,,,,
DEFAULT,95215,9,1,0,10
,,,,
DEFAULT,33987,7,0,0,7
,,,,
,,,,
,,,,
GREEDY,19022,8,2,1,11
,,,,
,,,,
,,,,
DEFAULT,30435,4,0,0,4
,,,,
DEFAULT,53013,9,0,0,9
,,,,
STATION_GUY,51156,6,0,1,7
,,,,
,,,,
UTILITY_GUY,26574,4,1,1,6
GREEDY,13045,8,0,3,11
,,,,
,,,,
DEFAULT,36304,5,1,0,6
,,,,
,,,,
,,,,
UTILITY_GUY,68866,4,0,1,5
,,,,
,,,,
GREEDY,19278,8,1,1,10
GREEDY,93642,8,1,1,10
,,,,
,,,,
UTILITY_GUY,56124,4,0,0,4
,,,,
GREEDY,17728,8,0,2,10
,,,,
,,,,
GREEDY,15028,9,1,0,10
GREEDY,10357,5,1,2,8
STATION_GUY,41408,2,0,4,6
,,,,
,,,,
STATION_GUY,70473,5,0,4,9
GREEDY,15335,8,0,2,10
,,,,
GREEDY,31334,6,2,4,12
GREEDY,19052,10,1,2,13
,,,,
UTILITY_GUY,26255,6,1,0,7
,,,,
DEFAULT,35188,9,0,2,11
,,,,
,,,,
GREEDY,24756,9,0,1,10
,,,,
,,,,
,,,,
GREEDY,23292,12,2,2,16
,,,,
,,,,
GREEDY,28817,7,0,2,9
,,,,
,,,,
,,,,
,,,,
STATION_GUY,26121,4,0,3,7
DEFAULT,45168,7,1,1,9
,,,,
,,,,
,,,,
,,,,
STATION_GUY,27206,4,1,4,9
,,,,
,,,,
,,,,
GREEDY,16677,8,0,1,9
,,,,
,,,,
,,,,
,,,,
GREEDY,13623,7,1,1,9
DEFAULT,22326,2,1,0,3
,,,,
,,,,
,,,,
,,,,
,,,,
GREEDY,9779,10,1,1,12
,,,,
DEFAULT,33650,5,0,1,6
,,,,
,,,,
UTILITY_GUY,38339,3,1,1,5
GREEDY,30638,8,1,0,9
,,,,
,,,,
GREEDY,30843,7,0,2,9
DEFAULT,50207,9,0,0,9
,,,,
,,,,
,,,,
,,,,
DEFAULT,60096,8,0,2,10
UTILITY_GUY,34057,6,1,1,8
,,,,
DEFAULT,59246,6,1,0,7
GREEDY,83555,9,0,2,11
,,,,
,,,,
,,,,
STATION_GUY,52574,8,0,1,9
STATION_GUY,26501,8,0,0,8
GREEDY,28093,5,0,3,8
GREEDY,17311,8,0,2,10
,,,,
STATION_GUY,28061,5,0,4,9
GREEDY,19664,10,0,1,11
,,,,
,,,,
,,,,
DEFAULT,30597,5,0,1,6
,,,,
,,,,
,,,,
UTILITY_GUY,26657,7,0,0,7
,,,,
,,,,
,,,,
GREEDY,28985,8,1,1,10
,,,,
GREEDY,17719,9,0,2,11
,,,,
STATION_GUY,94181,8,0,1,9
,,,,
,,,,
,,,,
GREEDY,11445,7,0,0,7
,,,,
GREEDY,42747,9,0,1,10
,,,,
,,,,
,,,,
,,,,
,,,,
GREEDY,20102,12,0,2,14
DEFAULT,56848,8,0,0,8
,,,,
STATION_GUY,44386,6,0,2,8
GREEDY,16349,12,1,0,13
,,,,
GREEDY,10481,9,0,0,9
,,,,
,,,,
GREEDY,22883,8,0,1,9
STATION_GUY,27850,5,0,1,6
GREEDY,21475,11,0,0,11
DEFAULT,51019,8,0,1,9
,,,,
GREEDY,29619,9,0,0,9
,,,,
,,,,
,,,,
,,,,
,,,,
GREEDY,20084,7,1,1,9
UTILITY_GUY,38251,8,1,0,9
,,,,
GREEDY,42650,7,0,4,11
,,,,
,,,,
UTILITY_GUY,26146,3,1,4,8
STATION_GUY,41362,6,0,1,7
,,,,
STATION_GUY,92846,4,0,1,5
,,,,
,,,,
GREEDY,33213,11,1,2,14
GREEDY,19025,9,0,1,10
,,,,
GREEDY,35047,8,0,0,8
,,,,
,,,,
,,,,
,,,,
,,,,
DEFAULT,31297,7,0,0,7
,,,,
,,,,
,,,,
UTILITY_GUY,29413,6,1,0,7
,,,,
DEFAULT,10820,5,0,0,5
STATION_GUY,76922,5,0,1,6
,,,,
GREEDY,19276,9,2,0,11
,,,,
,,,,
GREEDY,22192,10,0,3,13
,,,,
,,,,
,,,,
UTILITY_GUY,67223,6,0,2,8
,,,,
,,,,
,,,,
,,,,
GREEDY,39582,10,0,0,10
GREEDY,11083,9,1,0,10
,,,,
,,,,
,,,,
,,,,
,,,,
,,,,
GREEDY,38213,10,0,0,10
,,,,
,,,,
,,,,
GREEDY,24592,9,0,0,9
,,,,
,,,,
,,,,
GREEDY,10069,11,1,0,12
GREEDY,20067,11,0,0,11
GREEDY,14169,5,0,1,6
GREEDY,25177,6,1,1,8
,,,,
,,,,
,,,,
,,,,
GREEDY,10213,8,0,0,8
GREEDY,78821,10,0,2,12
,,,,
,,,,
,,,,
,,,,
,,,,
GREEDY,10641,10,2,1,13
DEFAULT,29218,7,1,1,9
GREEDY,16744,10,1,1,12
GREEDY,31922,7,0,1,8
,,,,
,,,,
GREEDY,22055,8,1,1,10
UTILITY_GUY,91754,7,0,0,7
UTILITY_GUY,48348,5,0,0,5
,,,,
,,,,
GREEDY,21768,8,0,2,10
DEFAULT,44360,6,0,1,7
GREEDY,85726,13,1,0,14
,,,,
,,,,
,,,,
,,,,
GREEDY,28738,10,1,0,11
,,,,
,,,,
,,,,
,,,,
,,,,
,,,,
GREEDY,13123,6,0,3,9
,,,,
GREEDY,17703,8,1,1,10
GREEDY,50605,8,0,0,8
,,,,
,,,,
STATION_GUY,75032,5,0,1,6
,,,,
,,,,
,,,,
,,,,
GREEDY,20693,9,0,3,12
,,,,
GREEDY,19797,9,1,1,11
GREEDY,16575,10,0,1,11
STATION_GUY,26394,3,1,3,7
STATION_GUY,26112,8,0,0,8
,,,,
,,,,
,,,,
,,,,
,,,,
GREEDY,49626,8,0,2,10
GREEDY,14331,9,0,0,9
GREEDY,17331,8,1,2,11
,,,,
,,,,
,,,,
,,,,
GREEDY,19623,7,1,2,10
DEFAULT,39676,8,1,0,9
,,,,
,,,,
,,,,
,,,,
,,,,
,,,,
,,,,
GREEDY,11110,10,0,2,12
,,,,
,,,,
STATION_GUY,53871,7,1,1,9
STATION_GUY,24992,4,0,4,8
GREEDY,29616,6,1,2,9
,,,,
,,,,
,,,,
,,,,
GREEDY,26654,8,0,0,8
GREEDY,19294,10,0,2,12
,,,,
,,,,
GREEDY,94540,12,0,1,13
GREEDY,17297,9,1,1,11
,,,,
,,,,
,,,,
,,,,
GREEDY,25137,7,1,0,8
UTILITY_GUY,65804,3,1,0,4
,,,,
,,,,
UTILITY_GUY,35513,8,0,1,9
GREEDY,19320,10,0,2,12
,,,,
UTILITY_GUY,49782,4,2,1,7
,,,,
,,,,
UTILITY_GUY,44711,5,2,1,8
,,,,
DEFAULT,63857,9,0,1,10
GREEDY,17891,8,0,1,9
,,,,
,,,,
,,,,
STINGY,90698,4,1,0,5
,,,,
,,,,
STATION_GUY,51644,7,0,1,8
,,,,
,,,,
GREEDY,13717,7,2,1,10
,,,,
GREEDY,22501,6,0,0,6
GREEDY,39035,6,0,2,8
GREEDY,24937,8,1,1,10
,,,,
,,,,
,,,,
DEFAULT,31782,8,0,0,8
,,,,
,,,,
,,,,
,,,,
,,,,
STATION_GUY,69677,6,0,4,10
,,,,
,,,,
DEFAULT,50737,6,0,0,6
,,,,
,,,,
,,,,
,,,,
,,,,
,,,,
,,,,
,,,,
,,,,
,,,,
,,,,
,,,,
,,,,
,,,,
,,,,
,,,,
,,,,
,,,,
,,,,
,,,,
,,,,
,,,,
,,,,
,,,,
DEFAULT,72703,7,0,0,7
,,,,
,,,,
UTILITY_GUY,16410,9,1,0,10
,,,,
,,,,
,,,,
UTILITY_GUY,39844,4,2,1,7
,,,,
,,,,
STATION_GUY,47037,7,0,2,9
,,,,
,,,,
STATION_GUY,53096,10,0,0,10
,,,,
GREEDY,33699,13,0,1,14
,,,,
GREEDY,24151,8,0,1,9
,,,,
,,,,
,,,,
,,,,
GREEDY,9958,8,1,1,10
GREEDY,22783,9,0,1,10
GREEDY,53584,11,0,0,11
GREEDY,16476,6,2,2,10
,,,,
STATION_GUY,17945,7,0,0,7
,,,,
,,,,
GREEDY,32288,10,1,0,11
,,,,
,,,,
DEFAULT,53483,7,0,0,7
,,,,
,,,,
,,,,
,,,,
,,,,
,,,,
,,,,
,,,,
,,,,
,,,,
,,,,
GREEDY,14822,10,0,1,11
,,,,
,,,,
UTILITY_GUY,57031,4,0,2,6
,,,,
,,,,
,,,,
,,,,
,,,,
,,,,
DEFAULT,27351,7,0,1,8
,,,,
,,,,
DEFAULT,65224,9,0,0,9
GREEDY,19671,8,1,0,9
,,,,
,,,,
,,,,
,,,,
GREEDY,27721,8,1,0,9
,,,,
GREEDY,17340,9,1,1,11
,,,,
,,,,
,,,,
GREEDY,51290,8,2,1,11
,,,,
,,,,
,,,,
GREEDY,20395,7,0,1,8
,,,,
,,,,
,,,,
UTILITY_GUY,34979,4,0,1,5
GREEDY,18366,9,0,1,10
,,,,
UTILITY_GUY,38902,7,0,0,7
UTILITY_GUY,41749,6,0,1,7
,,,,
,,,,
,,,,
,,,,
GREEDY,13143,12,0,2,14
,,,,
GREEDY,14935,9,0,1,10
DEFAULT,68895,5,1,0,6
,,,,
UTILITY_GUY,29596,5,1,0,6
STATION_GUY,51701,2,1,0,3
,,,,
,,,,
,,,,
UTILITY_GUY,76363,3,0,1,4
DEFAULT,32468,8,1,1,10
,,,,
,,,,
,,,,
GREEDY,16071,8,0,1,9
STATION_GUY,16522,2,1,2,5
,,,,
,,,,
,,,,
,,,,
GREEDY,22748,4,1,1,6
GREEDY,45504,9,0,1,10
,,,,
GREEDY,16507,10,1,1,12
,,,,
,,,,
DEFAULT,11832,5,0,1,6
,,,,
,,,,
,,,,
,,,,
,,,,
,,,,
,,,,
,,,,
,,,,
UTILITY_GUY,34051,8,0,0,8
,,,,
,,,,
,,,,
,,,,
,,,,
,,,,
,,,,
DEFAULT,32318,7,0,1,8
,,,,
,,,,
GREEDY,29424,7,2,0,9
DEFAULT,48182,4,1,1,6
,,,,
GREEDY,27203,9,1,0,10
GREEDY,22901,11,0,0,11
DEFAULT,32630,4,0,1,5
,,,,
DEFAULT,34433,8,0,1,9
,,,,
,,,,
,,,,
STATION_GUY,40487,4,0,2,6
GREEDY,20674,7,1,1,9
,,,,
,,,,
,,,,
GREEDY,34028,11,1,0,12
,,,,
GREEDY,24444,14,2,1,17
,,,,
,,,,
,,,,
,,,,
,,,,
GREEDY,37335,8,0,0,8
,,,,
,,,,
,,,,
,,,,
,,,,
,,,,
,,,,
,,,,
,,,,
,,,,
,,,,
DEFAULT,70195,7,0,1,8
UTILITY_GUY,28720,5,1,1,7
,,,,
,,,,
,,,,
,,,,
DEFAULT,86055,9,0,0,9
GREEDY,14539,6,0,1,7
,,,,
,,,,
,,,,
,,,,
,,,,
,,,,
,,,,
STATION_GUY,35510,6,1,1,8
,,,,
GREEDY,36176,11,0,1,12
GREEDY,20835,8,1,0,9
STATION_GUY,20468,4,1,4,9
,,,,
GREEDY,17478,7,1,1,9
GREEDY,72955,9,0,0,9
DEFAULT,37127,9,1,0,10
,,,,
STINGY,57333,2,0,1,3
DEFAULT,79061,3,1,1,5
,,,,
,,,,
,,,,
,,,,
,,,,
DEFAULT,70704,8,0,0,8
,,,,
,,,,
,,,,
,,,,
DEFAULT,38422,7,1,0,8
,,,,
,,,,
,,,,
,,,,
,,,,
,,,,
STATION_GUY,32536,6,0,2,8
,,,,
,,,,
,,,,
,,,,
,,,,
GREEDY,28245,11,0,0,11
,,,,
,,,,
,,,,
DEFAULT,31998,4,0,0,4
,,,,
STATION_GUY,51137,7,0,1,8
UTILITY_GUY,58803,8,0,0,8
,,,,
GREEDY,13525,10,0,1,11
,,,,
GREEDY,19880,8,0,0,8
GREEDY,23193,6,0,0,6
DEFAULT,39929,6,0,1,7
,,,,
,,,,
,,,,
,,,,
DEFAULT,35655,7,1,0,8
STINGY,51938,3,1,1,5
,,,,
STATION_GUY,31423,4,0,3,7
GREEDY,33785,4,1,0,5
STATION_GUY,15713,5,0,4,9
,,,,
,,,,
,,,,
,,,,
,,,,
,,,,
,,,,
STATION_GUY,48480,5,0,0,5
,,,,
DEFAULT,31074,6,0,1,7
STATION_GUY,39844,4,0,2,6
,,,,
GREEDY,31536,10,1,0,11
GREEDY,17236,12,0,2,14
,,,,
,,,,
,,,,
,,,,
DEFAULT,35531,9,0,0,9
GREEDY,16333,10,0,3,13
STATION_GUY,30687,10,0,0,10
STATION_GUY,24055,6,0,1,7
,,,,
,,,,
,,,,
,,,,
,,,,
,,,,
,,,,
,,,,
,,,,
,,,,
,,,,
,,,,
GREEDY,13941,5,1,1,7
STATION_GUY,53705,4,0,4,8
,,,,
UTILITY_GUY,66380,4,1,0,5
,,,,
GREEDY,18804,11,0,2,13
,,,,
,,,,
GREEDY,19197,10,1,1,12
,,,,
GREEDY,20890,8,1,2,11
DEFAULT,34967,5,1,1,7
,,,,
GREEDY,31164,9,1,0,10
,,,,
,,,,
GREEDY,31488,12,0,1,13
,,,,
GREEDY,31570,12,0,0,12
,,,,
,,,,
,,,,
,,,,
GREEDY,23239,6,2,2,10
GREEDY,13490,8,0,2,10
,,,,
,,,,
GREEDY,10720,7,1,1,9
,,,,
,,,,
,,,,
,,,,
STATION_GUY,10540,8,0,1,9
GREEDY,17188,11,0,0,11
,,,,
,,,,
,,,,
,,,,
,,,,
,,,,
GREEDY,16508,8,1,1,10
,,,,
,,,,
,,,,
,,,,
,,,,
DEFAULT,27908,5,1,1,7
UTILITY_GUY,29591,5,0,0,5
,,,,
,,,,
,,,,
,,,,
,,,,
,,,,
,,,,
,,,,
,,,,
UTILITY_GUY,32273,4,1,2,7
,,,,
,,,,
UTILITY_GUY,21375,8,0,0,8
DEFAULT,26684,5,0,1,6
GREEDY,28939,6,0,1,7
,,,,
GREEDY,11329,5,1,1,7
,,,,
,,,,
,,,,
,,,,
,,,,
,,,,
,,,,
GREEDY,13387,10,0,2,12
,,,,
GREEDY,29292,11,0,2,13
,,,,
,,,,
,,,,
GREEDY,13557,10,1,1,12
GREEDY,26274,8,0,1,9
,,,,
DEFAULT,26552,9,1,0,10
GREEDY,41859,10,0,1,11
STATION_GUY,39053,5,0,2,7
,,,,
,,,,
,,,,
,,,,
,,,,
,,,,
STATION_GUY,39456,5,0,4,9
GREEDY,34711,9,1,1,11
GREEDY,62201,5,0,4,9
,,,,
,,,,
GREEDY,10240,10,1,2,13
,,,,
,,,,
,,,,
GREEDY,17745,9,1,0,10
DEFAULT,74385,5,1,1,7
STINGY,75480,3,0,0,3
,,,,
,,,,
,,,,
,,,,
,,,,
,,,,
STATION_GUY,42020,5,1,4,10
,,,,
,,,,
,,,,
DEFAULT,33161,6,0,0,6
GREEDY,56348,8,0,2,10
,,,,
,,,,
,,,,
,,,,
,,,,
GREEDY,21544,8,1,0,9
,,,,
,,,,
,,,,
,,,,
,,,,
STATION_GUY,52477,2,0,1,3
GREEDY,22006,8,0,1,9
UTILITY_GUY,35197,3,0,1,4
GREEDY,70130,9,0,0,9
GREEDY,21507,11,1,0,12
GREEDY,53660,8,1,1,10
,,,,
GREEDY,21163,8,1,0,9
,,,,
,,,,
,,,,
,,,,
,,,,
,,,,
,,,,
,,,,
,,,,
,,,,
GREEDY,19079,13,0,3,16
GREEDY,44965,10,0,1,11
GREEDY,26438,12,1,1,14
STATION_GUY,74352,6,0,1,7
UTILITY_GUY,44267,9,1,0,10
,,,,
,,,,
,,,,
,,,,
GREEDY,13054,10,1,0,11
,,,,
,,,,
,,,,
,,,,
,,,,
STATION_GUY,65635,6,0,1,7
,,,,
,,,,
,,,,
,,,,
,,,,
,,,,
GREEDY,15062,8,2,1,11
GREEDY,12515,9,0,0,9
GREEDY,25634,11,1,1,13
,,,,
GREEDY,56790,5,1,2,8
UTILITY_GUY,31795,4,2,0,6
,,,,
,,,,
,,,,
STATION_GUY,32131,6,0,3,9
,,,,
,,,,
,,,,
,,,,
GREEDY,16563,8,1,1,10
,,,,
,,,,
,,,,
,,,,
,,,,
GREEDY,28774,8,0,2,10
,,,,
,,,,
STATION_GUY,37225,5,0,2,7
,,,,
,,,,
GREEDY,11352,10,1,0,11
,,,,
GREEDY,18200,5,1,0,6
,,,,
STATION_GUY,37027,5,1,2,8
,,,,
GREEDY,51704,11,1,0,12
DEFAULT,18814,5,1,0,6
GREEDY,32945,10,1,1,12
,,,,
,,,,
UTILITY_GUY,47308,7,0,0,7
STATION_GUY,53898,6,0,1,7
,,,,
,,,,
,,,,
,,,,
,,,,
STATION_GUY,45778,5,0,4,9
UTILITY_GUY,27699,9,1,0,10
,,,,
DEFAULT,27126,6,0,0,6
,,,,
GREEDY,25843,10,0,3,13
,,,,
,,,,
,,,,
GREEDY,22007,8,2,0,10
GREEDY,21010,10,1,1,12
GREEDY,15277,7,1,1,9
,,,,
,,,,
,,,,
UTILITY_GUY,31755,4,2,1,7
,,,,
,,,,
GREEDY,14609,8,0,2,10
,,,,
,,,,
,,,,
,,,,
,,,,
,,,,
,,,,
,,,,
,,,,
GREEDY,17957,10,1,1,12
,,,,
DEFAULT,20605,8,0,0,8
GREEDY,23815,6,0,2,8
,,,,
GREEDY,16595,12,1,3,16
,,,,
,,,,
,,,,
STINGY,78917,4,0,0,4
,,,,
,,,,
STATION_GUY,39862,6,0,1,7
,,,,
,,,,
UTILITY_GUY,49776,6,1,1,8
DEFAULT,68416,7,1,1,9
,,,,
,,,,
,,,,
,,,,
GREEDY,27792,8,0,2,10
,,,,
STATION_GUY,40910,9,0,1,10
,,,,
,,,,
,,,,
UTILITY_GUY,48671,7,1,1,9
GREEDY,22714,9,1,1,11
GREEDY,53580,8,1,1,10
GREEDY,17348,8,1,1,10
,,,,
,,,,
GREEDY,30585,8,1,1,10
GREEDY,36710,7,1,1,9
UTILITY_GUY,68120,6,1,1,8
GREEDY,38199,10,0,1,11
,,,,
,,,,
GREEDY,29946,10,0,3,13
DEFAULT,48314,3,2,2,7
DEFAULT,40951,6,0,0,6
,,,,
,,,,
,,,,
STINGY,83141,5,1,0,6
GREEDY,13268,9,0,2,11
,,,,
,,,,
,,,,
,,,,
GREEDY,14792,8,0,0,8
,,,,
,,,,
,,,,
GREEDY,19158,7,0,0,7
GREEDY,21201,9,0,1,10
,,,,
,,,,
,,,,
,,,,
,,,,
,,,,
GREEDY,26590,7,0,2,9
GREEDY,24808,7,0,1,8
,,,,
DEFAULT,19560,3,1,0,4
GREEDY,10966,9,0,1,10
STATION_GUY,60283,7,1,1,9
,,,,
,,,,
,,,,
,,,,
UTILITY_GUY,34797,6,1,0,7
,,,,
,,,,
,,,,
DEFAULT,39314,8,0,1,9
,,,,
,,,,
STATION_GUY,48832,6,0,0,6
,,,,
,,,,
,,,,
GREEDY,19937,5,1,1,7
DEFAULT,47929,6,0,0,6
,,,,
,,,,
DEFAULT,51365,5,0,0,5
,,,,
,,,,
,,,,
DEFAULT,44570,4,1,2,7
,,,,
,,,,
,,,,
,,,,
,,,,
,,,,
,,,,
,,,,
UTILITY_GUY,32018,5,0,2,7
GREEDY,19266,9,0,2,11
UTILITY_GUY,62509,9,1,1,11
,,,,
,,,,
GREEDY,17931,8,1,0,9
DEFAULT,82114,5,0,0,5
UTILITY_GUY,32863,5,1,0,6
,,,,
,,,,
STATION_GUY,62624,4,0,4,8
,,,,
,,,,
,,,,
,,,,
,,,,
,,,,
,,,,
,,,,
,,,,
,,,,
,,,,
,,,,
GREEDY,28459,8,2,2,12
,,,,
,,,,
,,,,
DEFAULT,24545,8,1,0,9
,,,,
,,,,
,,,,
DEFAULT,40881,7,0,0,7
,,,,
,,,,
GREEDY,29350,10,1,3,14
,,,,
,,,,
,,,,
,,,,
GREEDY,13726,10,1,1,12
,,,,
GREEDY,13553,9,0,1,10
STATION_GUY,19996,4,0,4,8
,,,,
GREEDY,23946,8,2,3,13
GREEDY,42144,7,1,0,8
,,,,
,,,,
GREEDY,26055,11,1,1,13
DEFAULT,33014,5,0,1,6
GREEDY,49862,6,0,1,7
,,,,
,,,,
GREEDY,19628,11,0,0,11
STATION_GUY,49418,5,0,1,6
GREEDY,77649,12,1,0,13
,,,,
,,,,
,,,,
DEFAULT,19322,6,0,2,8
,,,,
,,,,
,,,,
,,,,
,,,,
,,,,
,,,,
DEFAULT,74091,6,1,1,8
DEFAULT,46116,9,0,0,9
STATION_GUY,42511,3,1,2,6
,,,,
GREEDY,37153,11,1,1,13
,,,,
,,,,
,,,,
,,,,
STATION_GUY,46950,9,0,0,9
UTILITY_GUY,69013,6,0,1,7
,,,,
,,,,
,,,,
UTILITY_GUY,38542,3,1,1,5
,,,,
,,,,
,,,,
,,,,
STINGY,91112,7,0,0,7
,,,,
,,,,
UTILITY_GUY,46954,8,0,0,8
,,,,
,,,,
,,,,
,,,,
,,,,
,,,,
STATION_GUY,57019,6,1,1,8
,,,,
,,,,
GREEDY,47994,14,0,0,14
GREEDY,18282,10,1,1,12
GREEDY,19015,13,0,1,14
,,,,
,,,,
,,,,
,,,,
DEFAULT,40758,9,1,0,10
DEFAULT,70182,7,1,0,8
,,,,
UTILITY_GUY,55147,4,1,0,5
,,,,
UTILITY_GUY,50600,4,1,1,6
,,,,
,,,,
DEFAULT,48517,8,0,1,9
,,,,
,,,,
,,,,
GREEDY,21207,6,0,1,7
STATION_GUY,59304,5,0,1,6
UTILITY_GUY,28765,5,0,0,5
,,,,
DEFAULT,51985,7,0,2,9
,,,,
,,,,
GREEDY,22914,8,0,1,9
GREEDY,23920,7,0,0,7
GREEDY,29191,8,0,1,9
,,,,
,,,,
,,,,
,,,,
,,,,
,,,,
GREEDY,16665,9,1,0,10
GREEDY,17666,10,1,2,13
,,,,
,,,,
,,,,
GREEDY,19982,9,2,2,13
GREEDY,13718,6,0,0,6
GREEDY,32179,11,0,0,11
UTILITY_GUY,58931,7,1,1,9
,,,,
DEFAULT,40445,8,1,0,9
,,,,
,,,,
STATION_GUY,44856,8,1,1,10
DEFAULT,28749,10,0,0,10
,,,,
,,,,
,,,,
,,,,
DEFAULT,45793,5,0,1,6
,,,,
,,,,
GREEDY,14368,7,0,1,8
GREEDY,21600,8,0,0,8
GREEDY,19126,9,0,1,10
,,,,
,,,,
STATION_GUY,30343,4,0,1,5
,,,,
,,,,
UTILITY_GUY,42639,8,1,0,9
STATION_GUY,31188,4,0,1,5
,,,,
GREEDY,15329,5,2,3,10
GREEDY,36885,10,0,0,10
STATION_GUY,31953,8,0,1,9
,,,,
,,,,
UTILITY_GUY,15000,6,1,1,8
GREEDY,29573,13,0,2,15
,,,,
,,,,
UTILITY_GUY,62755,5,2,0,7
GREEDY,24611,9,1,1,11
,,,,
,,,,
,,,,
GREEDY,17413,12,1,0,13
,,,,
,,,,
,,,,
,,,,
,,,,
,,,,
,,,,
UTILITY_GUY,66482,5,1,0,6
STATION_GUY,13012,3,0,4,7
UTILITY_GUY,64528,8,0,1,9
STATION_GUY,42762,7,0,4,11
,,,,
,,,,
,,,,
,,,,
,,,,
,,,,
GREEDY,11106,8,1,0,9
,,,,
,,,,
,,,,
,,,,
STATION_GUY,66392,5,0,3,8
,,,,
GREEDY,24292,8,1,1,10
,,,,
,,,,
,,,,
,,,,
GREEDY,17125,12,0,0,12
,,,,
DEFAULT,40619,6,0,1,7
,,,,
,,,,
,,,,
STATION_GUY,20293,3,2,1,6
UTILITY_GUY,48985,4,0,1,5
GREEDY,33700,8,0,2,10
,,,,
,,,,
STATION_GUY,68586,6,0,2,8
,,,,
,,,,
GREEDY,29787,11,0,0,11
UTILITY_GUY,19810,4,1,0,5
,,,,
,,,,
GREEDY,60051,10,0,1,11
STATION_GUY,41985,9,0,0,9
GREEDY,26082,11,1,0,12
STATION_GUY,38897,5,0,4,9
,,,,
GREEDY,15828,6,1,2,9
,,,,
,,,,
GREEDY,18220,7,0,0,7
,,,,
STATION_GUY,41506,5,0,0,5
UTILITY_GUY,56615,8,0,0,8
,,,,
,,,,
,,,,
,,,,
,,,,
,,,,
,,,,
,,,,
,,,,
GREEDY,16894,6,1,0,7
,,,,
DEFAULT,79047,4,0,0,4
GREEDY,18865,9,0,2,11
,,,,
,,,,
,,,,
,,,,
GREEDY,60112,13,0,0,13
,,,,
,,,,
,,,,
GREEDY,27363,9,0,1,10
GREEDY,32641,5,0,1,6
GREEDY,47410,9,0,1,10
,,,,
,,,,
,,,,
GREEDY,26545,9,1,1,11
GREEDY,22975,9,0,1,10
,,,,
,,,,
,,,,
,,,,
,,,,
,,,,
GREEDY,31641,7,2,1,10
,,,,
GREEDY,23969,10,1,0,11
,,,,
,,,,
GREEDY,24233,9,1,1,11
,,,,
GREEDY,23389,11,0,1,12
DEFAULT,58190,5,1,0,6
GREEDY,15603,10,1,2,13
,,,,
,,,,
DEFAULT,17535,5,0,0,5
,,,,
,,,,
,,,,
,,,,
,,,,
,,,,
,,,,
GREEDY,13144,9,1,0,10
GREEDY,46211,10,0,0,10
,,,,
UTILITY_GUY,39983,6,0,1,7
STATION_GUY,23515,7,1,0,8
,,,,
,,,,
,,,,
GREEDY,17540,9,1,0,10
GREEDY,19155,7,0,2,9
,,,,
,,,,
GREEDY,20160,6,0,1,7
,,,,
DEFAULT,38643,5,0,0,5
,,,,
,,,,
,,,,
,,,,
,,,,
GREEDY,95118,7,1,0,8
,,,,
DEFAULT,38967,8,0,0,8
,,,,
,,,,
,,,,
,,,,
,,,,
STATION_GUY,55617,6,1,1,8
,,,,
,,,,
,,,,
UTILITY_GUY,16989,5,1,1,7
STATION_GUY,17379,5,0,4,9
,,,,
,,,,
UTILITY_GUY,52482,6,1,1,8
,,,,
,,,,
,,,,
,,,,
GREEDY,12314,9,0,0,9
GREEDY,26109,8,0,1,9
STATION_GUY,65086,9,1,0,10
,,,,
,,,,
,,,,
GREEDY,16274,9,0,2,11
,,,,
GREEDY,20146,3,1,1,5
,,,,
,,,,
GREEDY,27349,10,2,0,12
,,,,
,,,,
,,,,
,,,,
,,,,
STATION_GUY,35764,5,1,1,7
GREEDY,17030,6,0,1,7
,,,,
GREEDY,14142,6,0,1,7
,,,,
DEFAULT,79580,9,0,1,10
,,,,
,,,,
,,,,
,,,,
DEFAULT,51910,8,0,0,8
,,,,
GREEDY,23320,9,1,0,10
,,,,
,,,,
,,,,
GREEDY,17463,10,1,1,12
,,,,
,,,,
GREEDY,15167,5,1,1,7
,,,,
,,,,
,,,,
GREEDY,52211,9,1,1,11
,,,,
STATION_GUY,34823,5,0,1,6
,,,,
DEFAULT,75383,8,0,0,8
,,,,
DEFAULT,24592,6,0,1,7
,,,,
,,,,
GREEDY,17258,11,0,1,12
,,,,
,,,,
DEFAULT,61968,4,1,1,6
GREEDY,12481,9,1,1,11
,,,,
,,,,
GREEDY,88374,11,1,1,13
,,,,
GREEDY,9820,5,0,1,6
DEFAULT,18641,5,0,0,5
,,,,
STATION_GUY,35230,4,0,2,6
,,,,
STINGY,50528,4,0,0,4
DEFAULT,34129,5,0,0,5
,,,,
,,,,
,,,,
GREEDY,17224,7,0,0,7
GREEDY,20120,10,2,1,13
,,,,
,,,,
GREEDY,16796,9,0,3,12
,,,,
,,,,
,,,,
GREEDY,17702,7,1,1,9
,,,,
,,,,
,,,,
,,,,
,,,,
,,,,
,,,,
,,,,
UTILITY_GUY,57535,5,2,0,7
STATION_GUY,58357,5,0,1,6
,,,,
,,,,
,,,,
,,,,
GREEDY,30691,9,1,0,10
,,,,
,,,,
,,,,
,,,,
GREEDY,17898,7,0,2,9
,,,,
DEFAULT,28573,4,0,1,5
STATION_GUY,30454,7,1,1,9
DEFAULT,35509,7,0,1,8
DEFAULT,25125,8,0,1,9
GREEDY,21274,12,0,0,12
,,,,
GREEDY,5229,8,1,1,10
DEFAULT,49190,8,1,1,10
,,,,
STATION_GUY,12467,1,1,4,6
STATION_GUY,32969,4,0,4,8
,,,,
GREEDY,12632,8,0,2,10
,,,,
,,,,
,,,,
,,,,
,,,,
,,,,
GREEDY,23071,12,0,1,13
DEFAULT,72612,6,0,0,6
,,,,
,,,,
,,,,
,,,,
,,,,
GREEDY,19561,7,1,1,9
,,,,
,,,,
STATION_GUY,14716,3,0,2,5
,,,,
,,,,
,,,,
UTILITY_GUY,40519,4,0,0,4
,,,,
,,,,
,,,,
,,,,
,,,,
GREEDY,56124,8,1,0,9
,,,,
,,,,
,,,,
,,,,
,,,,
,,,,
UTILITY_GUY,52915,5,2,0,7
GREEDY,19885,6,0,3,9
,,,,
,,,,
,,,,
,,,,
DEFAULT,54765,7,0,1,8
,,,,
,,,,
,,,,
UTILITY_GUY,49786,4,1,1,6
GREEDY,46251,9,0,0,9
,,,,
GREEDY,36951,9,0,0,9
,,,,
,,,,
GREEDY,21254,8,0,0,8
,,,,
,,,,
DEFAULT,61790,9,0,0,9
,,,,
,,,,
GREEDY,16799,7,0,1,8
,,,,
,,,,
,,,,
,,,,
UTILITY_GUY,52598,7,0,0,7
,,,,
,,,,
GREEDY,24509,8,0,3,11
,,,,
,,,,
STATION_GUY,42444,5,1,1,7
,,,,
STATION_GUY,40260,5,0,3,8
,,,,
,,,,
,,,,
GREEDY,17528,7,1,0,8
,,,,
GREEDY,16694,7,1,0,8
DEFAULT,84108,10,0,0,10
,,,,
GREEDY,47604,8,1,0,9
,,,,
,,,,
,,,,
GREEDY,48357,9,1,2,12
,,,,
GREEDY,48898,10,1,2,13
GREEDY,30154,8,1,0,9
GREEDY,42687,8,0,2,10
,,,,
UTILITY_GUY,67383,5,0,0,5
,,,,
,,,,
,,,,
GREEDY,99579,7,1,0,8
,,,,
,,,,
,,,,
UTILITY_GUY,40179,6,1,0,7
,,,,
,,,,
,,,,
UTILITY_GUY,37010,7,1,1,9
,,,,
,,,,
,,,,
,,,,
,,,,
,,,,
GREEDY,33674,9,2,1,12
STATION_GUY,94648,4,0,1,5
,,,,
,,,,
,,,,
,,,,
,,,,
,,,,
DEFAULT,39249,8,0,0,8
,,,,
GREEDY,67165,11,0,2,13
GREEDY,15603,4,1,1,6
,,,,
GREEDY,23980,6,0,2,8
,,,,
,,,,
,,,,
GREEDY,12664,8,1,0,9
,,,,
,,,,
,,,,
,,,,
,,,,
DEFAULT,27585,3,1,1,5
,,,,
UTILITY_GUY,77404,7,1,0,8
,,,,
,,,,
UTILITY_GUY,20177,7,1,1,9
,,,,
,,,,
GREEDY,74335,6,1,0,7
,,,,
GREEDY,19050,7,0,1,8
,,,,
UTILITY_GUY,18409,5,1,0,6
,,,,
GREEDY,16210,7,1,3,11
STATION_GUY,45127,5,1,1,7
,,,,
,,,,
,,,,
,,,,
GREEDY,19618,6,1,1,8
,,,,
,,,,
STATION_GUY,47545,6,0,1,7
,,,,
,,,,
DEFAULT,32774,5,1,0,6
GREEDY,40216,12,1,1,14
,,,,
,,,,
GREEDY,36612,10,0,1,11
,,,,
DEFAULT,27243,5,0,2,7
GREEDY,19559,10,1,1,12
,,,,
,,,,
,,,,
,,,,
,,,,
,,,,
,,,,
,,,,
,,,,
UTILITY_GUY,45775,8,1,0,9
,,,,
,,,,
STATION_GUY,56017,6,0,2,8
,,,,
DEFAULT,67231,6,0,2,8
,,,,
DEFAULT,70829,6,0,1,7
,,,,
,,,,
,,,,
,,,,
GREEDY,38575,9,1,0,10
,,,,
STATION_GUY,46385,5,0,1,6
,,,,
,,,,
,,,,
,,,,
,,,,
,,,,
,,,,
,,,,
,,,,
,,,,
UTILITY_GUY,39674,5,2,1,8
,,,,
,,,,
,,,,
,,,,
,,,,
GREEDY,15742,8,1,1,10
,,,,
,,,,
,,,,
,,,,
,,,,
,,,,
,,,,
UTILITY_GUY,26755,4,2,1,7
,,,,
GREEDY,22896,9,1,0,10
,,,,
,,,,
,,,,
,,,,
,,,,
GREEDY,8460,6,0,2,8
,,,,
,,,,
UTILITY_GUY,31065,6,0,0,6
,,,,
,,,,
,,,,
GREEDY,21722,6,1,2,9
,,,,
,,,,
,,,,
,,,,
GREEDY,7769,5,0,1,6
,,,,
UTILITY_GUY,74264,4,1,0,5
,,,,
GREEDY,50958,8,0,0,8
DEFAULT,49240,6,0,0,6
,,,,
,,,,
,,,,
,,,,
,,,,
,,,,
,,,,
,,,,
,,,,
,,,,
GREEDY,17456,9,1,0,10
,,,,
GREEDY,28906,8,1,3,12
DEFAULT,60734,8,0,0,8
,,,,
,,,,
,,,,
STATION_GUY,42215,4,1,3,8
,,,,
,,,,
,,,,
DEFAULT,19642,5,0,0,5
DEFAULT,53313,7,1,0,8
GREEDY,12586,11,1,0,12
DEFAULT,60213,9,0,0,9
DEFAULT,46541,5,1,0,6
GREEDY,25117,6,0,2,8
,,,,
STATION_GUY,20790,3,1,4,8
,,,,
,,,,
,,,,
GREEDY,38128,10,0,0,10
,,,,
GREEDY,21169,9,0,2,11
,,,,
GREEDY,12281,5,1,1,7
UTILITY_GUY,77878,6,1,0,7
,,,,
STATION_GUY,35737,7,0,1,8
DEFAULT,21175,8,1,0,9
,,,,
,,,,
,,,,
,,,,
,,,,
,,,,
,,,,
GREEDY,39569,9,0,1,10
,,,,
,,,,
,,,,
,,,,
,,,,
,,,,
,,,,
,,,,
,,,,
,,,,
DEFAULT,33945,10,0,1,11
UTILITY_GUY,42001,6,0,0,6
GREEDY,12665,9,0,2,11
,,,,
,,,,
GREEDY,32453,12,2,1,15
,,,,
,,,,
,,,,
STATION_GUY,48628,8,0,1,9
,,,,
GREEDY,84085,11,0,0,11
,,,,
GREEDY,23767,7,1,0,8
,,,,
GREEDY,21437,8,0,1,9
,,,,
,,,,
GREEDY,27864,9,0,1,10
DEFAULT,42295,7,1,0,8
,,,,
GREEDY,37163,8,0,1,9
,,,,
GREEDY,14814,7,0,0,7
,,,,
,,,,
,,,,
,,,,
,,,,
,,,,
,,,,
DEFAULT,31058,4,0,0,4
GREEDY,11101,5,0,3,8
,,,,
GREEDY,11029,10,1,1,12
STATION_GUY,46245,4,0,1,5
,,,,
,,,,
,,,,
,,,,
,,,,
GREEDY,23189,12,0,1,13
,,,,
,,,,
,,,,
,,,,
UTILITY_GUY,36406,5,2,0,7
GREEDY,26294,8,1,1,10
,,,,
DEFAULT,57880,5,0,0,5
GREEDY,14793,6,1,0,7
,,,,
,,,,
GREEDY,15463,9,0,2,11
,,,,
,,,,
GREEDY,76760,10,1,1,12
,,,,
GREEDY,20106,5,0,2,7
,,,,
UTILITY_GUY,22831,6,1,1,8
,,,,
,,,,
,,,,
,,,,
,,,,
,,,,
,,,,
GREEDY,20292,11,1,0,12
,,,,
,,,,
,,,,
,,,,
GREEDY,17737,6,0,2,8
,,,,
,,,,
,,,,
GREEDY,14638,11,1,1,13
,,,,
GREEDY,41252,11,0,2,13
GREEDY,15038,11,0,1,12
,,,,
,,,,
DEFAULT,44602,8,1,0,9
,,,,
,,,,
,,,,
GREEDY,20703,11,1,2,14
,,,,
,,,,
,,,,
,,,,
,,,,
,,,,
,,,,
GREEDY,49289,9,0,2,11
,,,,
GREEDY,54637,9,1,0,10
,,,,
,,,,
,,,,
,,,,
GREEDY,19368,7,1,1,9
,,,,
,,,,
STATION_GUY,40764,4,0,2,6
STATION_GUY,48837,5,0,0,5
DEFAULT,47639,8,0,0,8
,,,,
,,,,
,,,,
GREEDY,28644,8,1,1,10
