strategy,money,countries,utilities,stations,totalLandsOwned
DEFAULT,38912,6,0,2,8
,,,,
GREEDY,12750,13,0,0,13
,,,,
,,,,
,,,,
GREEDY,16754,9,0,2,11
,,,,
,,,,
,,,,
,,,,
,,,,
,,,,
,,,,
,,,,
UTILITY_GUY,56994,3,0,0,3
GREEDY,29005,12,1,1,14
,,,,
,,,,
,,,,
,,,,
,,,,
GREEDY,32467,8,1,1,10
,,,,
,,,,
,,,,
GREEDY,86258,9,1,2,12
,,,,
,,,,
,,,,
,,,,
,,,,
,,,,
,,,,
,,,,
,,,,
,,,,
GREEDY,27559,7,0,2,9
,,,,
GREEDY,27437,9,1,4,14
,,,,
,,,,
,,,,
,,,,
,,,,
,,,,
,,,,
,,,,
DEFAULT,14004,3,1,2,6
,,,,
STATION_GUY,21706,5,0,2,7
STINGY,96661,6,0,0,6
,,,,
,,,,
GREEDY,13853,11,0,1,12
,,,,
,,,,
,,,,
,,,,
DEFAULT,16438,5,0,3,8
UTILITY_GUY,31396,8,0,0,8
,,,,
GREEDY,13166,10,0,0,10
,,,,
STATION_GUY,94639,5,0,4,9
,,,,
,,,,
,,,,
,,,,
,,,,
,,,,
GREEDY,21984,7,0,1,8
,,,,
,,,,
,,,,
,,,,
,,,,
DEFAULT,22769,4,0,0,4
DEFAULT,52405,5,0,2,7
,,,,
,,,,
,,,,
DEFAULT,63063,8,0,0,8
,,,,
GREEDY,17896,7,0,0,7
,,,,
,,,,
,,,,
,,,,
GREEDY,25113,10,1,0,11
GREEDY,16538,10,1,1,12
,,,,
GREEDY,90909,8,0,0,8
GREEDY,36839,6,2,2,10
STATION_GUY,13880,2,2,4,8
,,,,
GREEDY,26186,6,0,1,7
,,,,
,,,,
GREEDY,21745,10,0,0,10
,,,,
GREEDY,26212,13,0,3,16
,,,,
,,,,
,,,,
,,,,
,,,,
,,,,
,,,,
,,,,
,,,,
,,,,
,,,,
,,,,
,,,,
,,,,
GREEDY,25776,8,2,2,12
,,,,
,,,,
STATION_GUY,47290,6,0,4,10
,,,,
GREEDY,32027,10,0,1,11
GREEDY,23815,7,0,1,8
STATION_GUY,25567,7,1,1,9
,,,,
GREEDY,18806,7,0,1,8
,,,,
,,,,
,,,,
,,,,
,,,,
STATION_GUY,42443,6,0,3,9
,,,,
GREEDY,23660,12,1,0,13
GREEDY,28182,10,0,1,11
,,,,
GREEDY,21589,8,1,1,10
,,,,
GREEDY,51851,12,0,2,14
,,,,
GREEDY,20687,6,2,4,12
,,,,
STATION_GUY,31086,3,0,2,5
,,,,
,,,,
GREEDY,15293,8,0,2,10
GREEDY,56252,8,0,2,10
,,,,
UTILITY_GUY,81504,5,1,1,7
,,,,
,,,,
GREEDY,21506,9,1,1,11
,,,,
,,,,
,,,,
STATION_GUY,47747,5,2,0,7
,,,,
GREEDY,21063,7,1,1,9
GREEDY,33660,11,1,3,15
,,,,
GREEDY,10799,9,1,0,10
,,,,
,,,,
,,,,
,,,,
,,,,
,,,,
,,,,
,,,,
,,,,
,,,,
GREEDY,25275,9,0,1,10
,,,,
STINGY,54883,2,0,0,2
,,,,
,,,,
,,,,
GREEDY,13191,11,1,0,12
,,,,
,,,,
STATION_GUY,57740,4,0,4,8
,,,,
,,,,
GREEDY,23448,9,0,0,9
,,,,
,,,,
,,,,
UTILITY_GUY,55931,5,1,1,7
,,,,
,,,,
,,,,
,,,,
,,,,
GREEDY,10140,8,1,0,9
,,,,
DEFAULT,57220,5,0,1,6
,,,,
,,,,
,,,,
GREEDY,14515,8,1,1,10
STATION_GUY,49126,6,1,1,8
GREEDY,21834,9,0,2,11
,,,,
,,,,
,,,,
,,,,
,,,,
,,,,
,,,,
GREEDY,43193,9,0,2,11
,,,,
,,,,
GREEDY,20744,13,1,2,16
,,,,
DEFAULT,37500,8,1,1,10
,,,,
GREEDY,16542,6,0,0,6
,,,,
DEFAULT,21606,4,1,1,6
GREEDY,22894,7,2,1,10
DEFAULT,16381,6,0,2,8
UTILITY_GUY,63209,5,1,1,7
GREEDY,14662,5,2,3,10
,,,,
GREEDY,60055,9,1,0,10
GREEDY,23291,6,1,1,8
,,,,
,,,,
,,,,
GREEDY,12956,8,0,2,10
,,,,
,,,,
STINGY,53456,4,0,0,4
,,,,
,,,,
GREEDY,15321,5,1,1,7
DEFAULT,42637,4,2,0,6
GREEDY,23252,7,1,0,8
,,,,
,,,,
,,,,
,,,,
STATION_GUY,50352,7,0,0,7
GREEDY,21524,8,0,1,9
,,,,
GREEDY,18742,6,1,2,9
,,,,
,,,,
,,,,
,,,,
UTILITY_GUY,44747,4,1,1,6
GREEDY,20289,9,0,2,11
,,,,
GREEDY,76286,10,0,1,11
GREEDY,34661,10,0,0,10
,,,,
,,,,
,,,,
UTILITY_GUY,72272,6,1,1,8
,,,,
,,,,
GREEDY,27080,9,2,0,11
,,,,
,,,,
GREEDY,21476,11,0,3,14
,,,,
,,,,
,,,,
GREEDY,25761,12,0,0,12
,,,,
DEFAULT,53658,5,1,0,6
,,,,
,,,,
,,,,
,,,,
,,,,
GREEDY,16579,9,0,1,10
,,,,
,,,,
UTILITY_GUY,80736,6,1,1,8
GREEDY,17957,9,0,0,9
,,,,
,,,,
,,,,
GREEDY,17415,11,0,0,11
,,,,
,,,,
,,,,
,,,,
GREEDY,24324,9,1,0,10
,,,,
,,,,
,,,,
GREEDY,20338,8,1,1,10
GREEDY,86578,8,1,1,10
GREEDY,46919,9,0,0,9
,,,,
GREEDY,67717,7,1,2,10
DEFAULT,61694,7,0,1,8
DEFAULT,43946,4,0,0,4
UTILITY_GUY,72153,7,1,0,8
STATION_GUY,41123,3,0,4,7
DEFAULT,34306,7,0,0,7
GREEDY,32345,5,0,0,5
UTILITY_GUY,16268,6,0,1,7
,,,,
,,,,
DEFAULT,29955,4,0,0,4
GREEDY,29937,10,1,0,11
GREEDY,24906,8,0,2,10
GREEDY,25740,10,0,1,11
,,,,
,,,,
GREEDY,15122,7,0,3,10
DEFAULT,33378,5,0,1,6
GREEDY,14448,8,0,0,8
GREEDY,20964,5,1,0,6
STATION_GUY,54094,6,1,0,7
,,,,
GREEDY,20148,11,0,1,12
DEFAULT,31957,4,1,0,5
UTILITY_GUY,19510,9,1,0,10
DEFAULT,61813,8,0,0,8
,,,,
,,,,
,,,,
GREEDY,12847,9,0,0,9
DEFAULT,59062,3,1,1,5
,,,,
,,,,
GREEDY,23575,9,0,1,10
STATION_GUY,14861,7,0,0,7
,,,,
GREEDY,15648,11,1,0,12
,,,,
STATION_GUY,51230,6,0,1,7
GREEDY,13139,8,0,3,11
,,,,
,,,,
,,,,
,,,,
,,,,
,,,,
,,,,
DEFAULT,37887,4,1,0,5
,,,,
,,,,
,,,,
GREEDY,15804,9,0,1,10
,,,,
,,,,
,,,,
,,,,
GREEDY,29766,7,0,2,9
,,,,
,,,,
GREEDY,25709,9,0,1,10
GREEDY,24038,9,1,2,12
GREEDY,35680,8,0,1,9
GREEDY,27654,10,1,0,11
,,,,
GREEDY,61438,7,0,0,7
,,,,
,,,,
,,,,
,,,,
GREEDY,20196,6,2,1,9
DEFAULT,41128,8,2,0,10
GREEDY,14690,8,2,2,12
,,,,
,,,,
,,,,
DEFAULT,15415,2,1,1,4
STATION_GUY,53687,6,0,1,7
,,,,
DEFAULT,72964,6,1,1,8
,,,,
,,,,
,,,,
,,,,
,,,,
GREEDY,12205,9,1,1,11
,,,,
,,,,
,,,,
UTILITY_GUY,49416,5,1,0,6
,,,,
DEFAULT,45546,3,1,1,5
,,,,
DEFAULT,38786,8,1,0,9
STATION_GUY,35476,4,0,4,8
,,,,
,,,,
,,,,
GREEDY,31144,6,1,1,8
,,,,
,,,,
,,,,
UTILITY_GUY,27198,4,1,0,5
DEFAULT,90215,8,0,0,8
,,,,
,,,,
,,,,
,,,,
,,,,
GREEDY,25507,9,0,1,10
,,,,
,,,,
,,,,
,,,,
GREEDY,25635,9,0,1,10
,,,,
,,,,
,,,,
STINGY,94001,4,0,0,4
,,,,
,,,,
,,,,
,,,,
,,,,
GREEDY,94974,7,0,0,7
,,,,
STATION_GUY,86139,7,1,2,10
,,,,
,,,,
,,,,
UTILITY_GUY,54030,5,1,0,6
,,,,
,,,,
DEFAULT,50194,8,1,0,9
GREEDY,57840,8,0,2,10
,,,,
,,,,
,,,,
,,,,
,,,,
GREEDY,27033,10,0,2,12
,,,,
,,,,
,,,,
,,,,
UTILITY_GUY,39105,3,1,1,5
,,,,
GREEDY,18950,10,0,2,12
STATION_GUY,46420,7,0,1,8
,,,,
STINGY,36722,3,0,2,5
,,,,
,,,,
,,,,
,,,,
,,,,
,,,,
,,,,
GREEDY,19013,7,1,1,9
,,,,
GREEDY,71475,9,1,0,10
,,,,
,,,,
DEFAULT,40226,8,1,0,9
,,,,
,,,,
,,,,
STATION_GUY,32441,8,0,2,10
,,,,
,,,,
,,,,
GREEDY,17417,8,1,0,9
,,,,
,,,,
STATION_GUY,55363,4,1,4,9
,,,,
,,,,
,,,,
,,,,
,,,,
,,,,
,,,,
,,,,
UTILITY_GUY,30113,6,0,0,6
,,,,
,,,,
,,,,
,,,,
,,,,
,,,,
,,,,
,,,,
UTILITY_GUY,45363,5,1,0,6
GREEDY,11472,7,1,3,11
,,,,
,,,,
,,,,
,,,,
,,,,
,,,,
,,,,
GREEDY,16628,11,1,1,13
,,,,
,,,,
,,,,
GREEDY,22041,8,1,0,9
,,,,
,,,,
,,,,
,,,,
,,,,
,,,,
,,,,
,,,,
UTILITY_GUY,17833,5,1,0,6
,,,,
,,,,
DEFAULT,47515,4,0,0,4
DEFAULT,23119,8,1,0,9
,,,,
,,,,
,,,,
GREEDY,36296,8,1,1,10
,,,,
,,,,
,,,,
DEFAULT,85979,4,0,1,5
GREEDY,19540,9,1,0,10
,,,,
,,,,
,,,,
GREEDY,28086,11,1,0,12
,,,,
GREEDY,10420,4,0,2,6
GREEDY,26536,8,2,1,11
,,,,
,,,,
,,,,
,,,,
,,,,
GREEDY,31381,8,0,3,11
GREEDY,27766,5,1,1,7
,,,,
,,,,
GREEDY,21249,10,1,2,13
,,,,
GREEDY,16432,6,1,2,9
,,,,
,,,,
,,,,
STATION_GUY,9605,2,0,4,6
,,,,
,,,,
,,,,
,,,,
,,,,
,,,,
,,,,
,,,,
GREEDY,26379,9,0,2,11
,,,,
UTILITY_GUY,46326,7,1,0,8
,,,,
,,,,
,,,,
DEFAULT,90911,8,1,1,10
,,,,
,,,,
,,,,
GREEDY,31787,10,1,1,12
,,,,
,,,,
,,,,
,,,,
,,,,
,,,,
,,,,
,,,,
,,,,
,,,,
,,,,
STATION_GUY,55508,5,1,1,7
,,,,
GREEDY,15763,11,0,1,12
DEFAULT,40467,9,1,1,11
GREEDY,27343,8,0,0,8
,,,,
,,,,
,,,,
,,,,
,,,,
,,,,
DEFAULT,40865,6,0,0,6
,,,,
,,,,
,,,,
,,,,
,,,,
,,,,
GREEDY,24956,5,1,0,6
DEFAULT,32845,10,0,0,10
,,,,
,,,,
GREEDY,30705,9,1,2,12
,,,,
,,,,
,,,,
,,,,
GREEDY,20260,4,0,3,7
,,,,
,,,,
,,,,
GREEDY,36284,9,0,1,10
GREEDY,34516,10,1,1,12
STATION_GUY,85716,6,1,1,8
,,,,
,,,,
GREEDY,23255,6,2,2,10
,,,,
DEFAULT,27439,5,0,2,7
,,,,
,,,,
,,,,
,,,,
,,,,
,,,,
,,,,
,,,,
,,,,
,,,,
STATION_GUY,47419,8,0,0,8
,,,,
DEFAULT,44553,7,1,1,9
,,,,
UTILITY_GUY,39218,6,0,1,7
,,,,
,,,,
GREEDY,15208,12,0,2,14
,,,,
GREEDY,20669,8,1,2,11
,,,,
GREEDY,14700,8,0,0,8
GREEDY,33213,9,1,0,10
,,,,
,,,,
GREEDY,21802,12,0,1,13
DEFAULT,52437,4,0,2,6
,,,,
,,,,
,,,,
,,,,
STATION_GUY,11594,3,1,4,8
DEFAULT,24691,3,1,3,7
,,,,
,,,,
,,,,
,,,,
UTILITY_GUY,20946,3,1,1,5
UTILITY_GUY,53480,7,0,0,7
,,,,
GREEDY,41243,6,0,2,8
UTILITY_GUY,24794,5,0,0,5
,,,,
GREEDY,18934,9,1,2,12
,,,,
GREEDY,16639,7,1,1,9
,,,,
,,,,
,,,,
,,,,
,,,,
,,,,
,,,,
DEFAULT,27024,3,1,1,5
GREEDY,29629,7,1,1,9
,,,,
,,,,
,,,,
,,,,
,,,,
,,,,
DEFAULT,45961,5,0,0,5
,,,,
STATION_GUY,46313,6,0,1,7
,,,,
,,,,
,,,,
GREEDY,75988,9,1,0,10
,,,,
DEFAULT,44635,6,0,1,7
,,,,
,,,,
GREEDY,23277,11,1,0,12
,,,,
,,,,
,,,,
,,,,
,,,,
,,,,
UTILITY_GUY,49149,6,1,0,7
DEFAULT,48613,5,1,2,8
STATION_GUY,34796,3,1,1,5
GREEDY,23423,3,1,0,4
,,,,
,,,,
,,,,
,,,,
,,,,
GREEDY,44436,9,0,1,10
GREEDY,27352,7,1,2,10
GREEDY,11910,9,0,1,10
,,,,
,,,,
,,,,
,,,,
GREEDY,45682,9,0,1,10
,,,,
,,,,
,,,,
GREEDY,24797,8,0,2,10
,,,,
,,,,
DEFAULT,90576,10,1,1,12
,,,,
,,,,
,,,,
GREEDY,30124,10,1,1,12
,,,,
GREEDY,29716,10,0,1,11
,,,,
,,,,
STATION_GUY,43678,6,0,0,6
,,,,
GREEDY,25452,6,0,2,8
,,,,
,,,,
DEFAULT,52537,6,0,3,9
GREEDY,19957,8,0,2,10
GREEDY,30702,7,0,1,8
,,,,
DEFAULT,21603,5,0,0,5
GREEDY,8397,8,0,0,8
,,,,
GREEDY,11200,10,0,0,10
,,,,
,,,,
,,,,
GREEDY,19338,9,1,2,12
,,,,
,,,,
,,,,
,,,,
,,,,
GREEDY,13527,10,0,2,12
,,,,
,,,,
,,,,
UTILITY_GUY,42867,5,0,0,5
,,,,
DEFAULT,61654,9,0,2,11
,,,,
,,,,
GREEDY,16597,8,1,1,10
,,,,
,,,,
,,,,
,,,,
,,,,
,,,,
GREEDY,17015,10,0,2,12
,,,,
,,,,
STATION_GUY,43724,9,0,0,9
GREEDY,19556,13,1,0,14
UTILITY_GUY,62069,6,1,0,7
,,,,
,,,,
GREEDY,30614,8,0,1,9
,,,,
GREEDY,17728,8,0,1,9
,,,,
GREEDY,24592,9,0,0,9
,,,,
,,,,
,,,,
,,,,
,,,,
,,,,
,,,,
GREEDY,25361,9,0,0,9
,,,,
GREEDY,13943,8,0,1,9
STATION_GUY,40357,7,0,3,10
,,,,
UTILITY_GUY,36084,8,0,0,8
,,,,
,,,,
,,,,
DEFAULT,24649,5,1,2,8
,,,,
STATION_GUY,51351,7,0,2,9
STINGY,88456,6,0,2,8
,,,,
GREEDY,27219,8,0,0,8
,,,,
,,,,
GREEDY,30514,6,0,1,7
,,,,
GREEDY,33621,10,1,0,11
DEFAULT,25455,6,0,0,6
,,,,
,,,,
DEFAULT,22188,3,0,1,4
,,,,
GREEDY,14472,9,0,4,13
,,,,
,,,,
,,,,
DEFAULT,63882,7,0,2,9
DEFAULT,25079,6,0,0,6
,,,,
,,,,
,,,,
,,,,
,,,,
,,,,
,,,,
DEFAULT,60468,10,0,1,11
GREEDY,39291,11,0,1,12
GREEDY,57697,6,1,1,8
,,,,
GREEDY,24039,9,1,0,10
,,,,
,,,,
,,,,
DEFAULT,12502,9,0,2,11
DEFAULT,46936,6,0,0,6
,,,,
STINGY,95099,5,0,0,5
DEFAULT,49366,5,0,0,5
,,,,
GREEDY,19270,10,1,1,12
,,,,
,,,,
,,,,
GREEDY,19457,9,0,2,11
,,,,
,,,,
DEFAULT,93329,7,0,1,8
,,,,
,,,,
,,,,
GREEDY,15912,8,1,1,10
,,,,
DEFAULT,64060,8,0,1,9
STATION_GUY,36299,8,0,1,9
,,,,
,,,,
,,,,
GREEDY,27155,8,1,1,10
,,,,
,,,,
GREEDY,12117,10,1,0,11
,,,,
,,,,
,,,,
,,,,
,,,,
GREEDY,98126,7,0,1,8
,,,,
,,,,
GREEDY,20620,9,2,3,14
,,,,
UTILITY_GUY,52670,5,1,1,7
,,,,
,,,,
,,,,
GREEDY,22834,8,1,0,9
GREEDY,16280,8,0,2,10
,,,,
,,,,
,,,,
,,,,
,,,,
,,,,
,,,,
,,,,
DEFAULT,37945,4,1,1,6
,,,,
GREEDY,16285,11,1,1,13
GREEDY,15254,11,1,2,14
GREEDY,29814,10,0,1,11
GREEDY,11686,7,0,3,10
GREEDY,15142,9,0,3,12
GREEDY,15727,5,0,0,5
,,,,
,,,,
,,,,
STATION_GUY,71976,5,1,0,6
,,,,
,,,,
,,,,
,,,,
,,,,
,,,,
GREEDY,33388,7,1,3,11
GREEDY,15737,7,1,3,11
STATION_GUY,80179,4,0,2,6
GREEDY,30899,9,0,0,9
DEFAULT,47920,5,0,0,5
,,,,
,,,,
,,,,
GREEDY,15255,7,0,0,7
,,,,
UTILITY_GUY,37369,6,1,1,8
,,,,
GREEDY,18244,4,1,1,6
DEFAULT,52346,5,1,1,7
,,,,
,,,,
,,,,
STINGY,50100,4,1,0,5
GREEDY,24579,8,0,1,9
GREEDY,13994,8,1,1,10
GREEDY,22858,9,0,1,10
STATION_GUY,65709,8,0,1,9
GREEDY,47854,7,0,0,7
,,,,
DEFAULT,45871,4,1,1,6
UTILITY_GUY,64237,5,0,0,5
GREEDY,19991,8,1,1,10
GREEDY,18649,7,0,1,8
GREEDY,16084,9,1,2,12
GREEDY,16918,6,0,0,6
,,,,
,,,,
,,,,
DEFAULT,45122,5,0,0,5
,,,,
STATION_GUY,48874,6,0,2,8
,,,,
,,,,
,,,,
DEFAULT,47298,8,0,0,8
,,,,
,,,,
UTILITY_GUY,23519,6,0,1,7
,,,,
,,,,
,,,,
,,,,
,,,,
,,,,
,,,,
,,,,
DEFAULT,24331,6,1,1,8
GREEDY,26763,5,0,1,6
,,,,
,,,,
,,,,
,,,,
,,,,
UTILITY_GUY,53929,5,1,1,7
,,,,
,,,,
,,,,
,,,,
GREEDY,34621,9,0,3,12
UTILITY_GUY,52386,7,1,0,8
,,,,
,,,,
GREEDY,28945,7,0,0,7
,,,,
GREEDY,36853,8,1,1,10
,,,,
,,,,
,,,,
UTILITY_GUY,15739,6,2,1,9
DEFAULT,83280,5,0,0,5
,,,,
,,,,
,,,,
,,,,
,,,,
,,,,
,,,,
GREEDY,36006,10,1,1,12
,,,,
,,,,
,,,,
GREEDY,18848,8,0,1,9
,,,,
,,,,
,,,,
GREEDY,13050,7,1,1,9
,,,,
,,,,
,,,,
,,,,
,,,,
,,,,
,,,,
,,,,
