strategy,money,countries,utilities,stations,totalLandsOwned
,,,,
,,,,
,,,,
,,,,
,,,,
,,,,
GREEDY,19101,11,1,0,12
GREEDY,21162,9,0,1,10
,,,,
,,,,
,,,,
,,,,
GREEDY,23307,8,1,3,12
,,,,
,,,,
,,,,
,,,,
,,,,
GREEDY,20693,9,2,1,12
,,,,
,,,,
,,,,
GREEDY,37153,11,0,1,12
STATION_GUY,54217,5,1,4,10
,,,,
,,,,
DEFAULT,39050,8,0,1,9
,,,,
GREEDY,24050,10,1,1,12
,,,,
,,,,
,,,,
UTILITY_GUY,57998,5,0,0,5
,,,,
,,,,
,,,,
,,,,
,,,,
,,,,
,,,,
,,,,
,,,,
,,,,
GREEDY,24000,7,1,1,9
,,,,
,,,,
,,,,
DEFAULT,49596,10,0,0,10
,,,,
,,,,
GREEDY,21121,8,0,2,10
GREEDY,25556,11,1,1,13
,,,,
,,,,
,,,,
STATION_GUY,20309,7,0,1,8
GREEDY,18016,9,1,1,11
,,,,
UTILITY_GUY,63883,7,1,0,8
,,,,
,,,,
,,,,
,,,,
,,,,
,,,,
STINGY,54763,3,0,0,3
,,,,
UTILITY_GUY,38108,6,0,0,6
,,,,
,,,,
,,,,
DEFAULT,25952,7,0,1,8
GREEDY,24401,8,1,1,10
GREEDY,29951,9,0,1,10
,,,,
,,,,
,,,,
GREEDY,95803,6,1,3,10
DEFAULT,25337,6,1,4,11
,,,,
,,,,
,,,,
,,,,
,,,,
,,,,
,,,,
,,,,
,,,,
,,,,
UTILITY_GUY,14133,7,0,0,7
STATION_GUY,25944,3,0,0,3
,,,,
,,,,
,,,,
,,,,
,,,,
,,,,
,,,,
,,,,
,,,,
GREEDY,34275,10,1,0,11
,,,,
,,,,
,,,,
,,,,
,,,,
,,,,
,,,,
DEFAULT,14404,6,1,1,8
GREEDY,13317,9,0,1,10
,,,,
,,,,
,,,,
GREEDY,89330,10,0,1,11
DEFAULT,23298,9,0,1,10
,,,,
,,,,
,,,,
UTILITY_GUY,52676,7,0,0,7
GREEDY,13085,8,0,0,8
,,,,
GREEDY,13454,12,1,2,15
,,,,
DEFAULT,37578,8,1,2,11
,,,,
,,,,
,,,,
,,,,
,,,,
,,,,
,,,,
GREEDY,35543,6,1,1,8
,,,,
,,,,
GREEDY,18075,6,2,2,10
GREEDY,27277,9,1,4,14
DEFAULT,45358,4,0,1,5
STATION_GUY,36300,8,0,1,9
,,,,
GREEDY,19536,10,2,2,14
DEFAULT,38877,5,0,1,6
,,,,
,,,,
DEFAULT,69815,5,0,0,5
,,,,
,,,,
GREEDY,26460,8,1,1,10
GREEDY,17073,7,0,0,7
,,,,
,,,,
,,,,
DEFAULT,41056,8,0,1,9
,,,,
UTILITY_GUY,59762,6,2,0,8
,,,,
,,,,
GREEDY,12679,7,0,2,9
,,,,
,,,,
,,,,
GREEDY,12001,12,0,1,13
GREEDY,46033,7,0,2,9
,,,,
,,,,
STATION_GUY,43566,3,0,4,7
,,,,
,,,,
,,,,
GREEDY,12782,9,1,0,10
,,,,
DEFAULT,38701,3,1,1,5
GREEDY,13479,7,0,1,8
,,,,
GREEDY,16956,8,1,1,10
,,,,
,,,,
DEFAULT,51429,5,0,0,5
,,,,
DEFAULT,46024,9,1,0,10
STATION_GUY,39151,6,1,4,11
DEFAULT,45931,6,0,1,7
,,,,
,,,,
,,,,
,,,,
,,,,
,,,,
,,,,
DEFAULT,22121,7,0,1,8
,,,,
,,,,
GREEDY,21353,9,0,1,10
,,,,
DEFAULT,43031,5,0,0,5
STATION_GUY,59364,5,0,2,7
,,,,
GREEDY,22351,11,0,1,12
DEFAULT,63790,8,0,0,8
,,,,
,,,,
GREEDY,37329,6,1,0,7
,,,,
,,,,
,,,,
GREEDY,40757,8,1,0,9
,,,,
GREEDY,20708,7,2,2,11
,,,,
,,,,
UTILITY_GUY,31582,2,0,2,4
,,,,
,,,,
,,,,
DEFAULT,84224,5,0,0,5
,,,,
GREEDY,25833,9,0,1,10
UTILITY_GUY,48024,4,1,2,7
,,,,
DEFAULT,48024,5,1,1,7
GREEDY,31919,6,0,0,6
GREEDY,17606,9,0,0,9
,,,,
GREEDY,16193,8,0,3,11
,,,,
,,,,
GREEDY,22993,7,0,1,8
,,,,
UTILITY_GUY,68277,4,1,0,5
STATION_GUY,46665,3,0,3,6
GREEDY,18448,6,0,1,7
,,,,
GREEDY,61284,10,0,1,11
,,,,
,,,,
,,,,
,,,,
GREEDY,30942,8,2,4,14
,,,,
,,,,
,,,,
GREEDY,15255,5,1,1,7
,,,,
,,,,
GREEDY,31589,8,0,1,9
,,,,
,,,,
,,,,
STATION_GUY,17937,2,0,4,6
GREEDY,19311,11,0,1,12
,,,,
,,,,
GREEDY,70331,11,0,0,11
,,,,
GREEDY,23285,7,1,0,8
,,,,
GREEDY,11876,5,1,1,7
,,,,
,,,,
,,,,
,,,,
GREEDY,13349,8,2,0,10
,,,,
GREEDY,28222,8,0,2,10
,,,,
STATION_GUY,29932,6,0,2,8
,,,,
GREEDY,18698,8,1,2,11
STATION_GUY,25939,5,1,3,9
,,,,
UTILITY_GUY,31058,11,0,1,12
,,,,
GREEDY,20067,9,1,0,10
,,,,
,,,,
DEFAULT,52914,7,0,1,8
,,,,
GREEDY,48189,11,0,2,13
,,,,
GREEDY,15241,9,0,3,12
,,,,
,,,,
,,,,
,,,,
,,,,
GREEDY,13646,9,0,2,11
STATION_GUY,34331,4,1,1,6
,,,,
,,,,
GREEDY,31120,7,1,2,10
,,,,
,,,,
,,,,
,,,,
,,,,
,,,,
,,,,
GREEDY,11310,11,1,2,14
DEFAULT,43484,6,1,2,9
GREEDY,29187,7,0,0,7
GREEDY,13776,7,1,2,10
UTILITY_GUY,60743,6,0,1,7
,,,,
,,,,
,,,,
,,,,
,,,,
GREEDY,25059,9,1,0,10
GREEDY,31893,9,1,1,11
,,,,
GREEDY,19065,9,1,0,10
DEFAULT,43376,7,0,0,7
,,,,
,,,,
UTILITY_GUY,59401,7,0,0,7
,,,,
,,,,
GREEDY,31488,8,2,1,11
,,,,
,,,,
,,,,
DEFAULT,40483,7,1,1,9
GREEDY,20835,7,1,3,11
,,,,
GREEDY,98940,11,1,1,13
,,,,
,,,,
UTILITY_GUY,39828,3,0,1,4
,,,,
STATION_GUY,39751,7,0,1,8
,,,,
UTILITY_GUY,35081,5,2,0,7
GREEDY,21113,8,0,0,8
,,,,
,,,,
GREEDY,8551,6,0,3,9
,,,,
GREEDY,58847,10,1,1,12
GREEDY,14365,9,0,0,9
,,,,
DEFAULT,66971,10,1,0,11
GREEDY,46994,11,0,2,13
STATION_GUY,72435,7,0,2,9
GREEDY,14552,7,0,1,8
,,,,
,,,,
,,,,
,,,,
GREEDY,27199,8,0,1,9
,,,,
,,,,
STATION_GUY,44351,6,0,2,8
,,,,
,,,,
,,,,
,,,,
,,,,
,,,,
,,,,
,,,,
,,,,
GREEDY,27331,9,0,2,11
STATION_GUY,23925,4,0,1,5
,,,,
,,,,
,,,,
UTILITY_GUY,25723,5,1,0,6
GREEDY,62968,6,1,4,11
,,,,
,,,,
,,,,
,,,,
,,,,
STATION_GUY,86750,8,0,1,9
GREEDY,12481,9,0,2,11
GREEDY,17132,7,0,3,10
,,,,
,,,,
,,,,
,,,,
,,,,
,,,,
,,,,
,,,,
,,,,
,,,,
,,,,
STATION_GUY,49403,4,1,2,7
,,,,
GREEDY,16067,9,0,2,11
,,,,
,,,,
,,,,
,,,,
GREEDY,34093,13,0,2,15
,,,,
STATION_GUY,17053,4,0,4,8
,,,,
GREEDY,24111,5,0,1,6
STATION_GUY,58545,7,0,1,8
,,,,
,,,,
,,,,
,,,,
GREEDY,12967,5,0,1,6
GREEDY,23957,10,0,1,11
,,,,
,,,,
UTILITY_GUY,51944,6,2,1,9
,,,,
UTILITY_GUY,20051,4,2,0,6
,,,,
,,,,
GREEDY,93319,7,0,0,7
,,,,
,,,,
,,,,
,,,,
UTILITY_GUY,63586,7,0,0,7
GREEDY,23339,8,1,1,10
STATION_GUY,85708,4,1,0,5
,,,,
,,,,
,,,,
,,,,
,,,,
STATION_GUY,18533,4,0,4,8
UTILITY_GUY,23364,5,0,0,5
,,,,
GREEDY,12363,9,1,2,12
DEFAULT,71970,4,0,0,4
,,,,
,,,,
,,,,
GREEDY,20937,8,2,2,12
STATION_GUY,54170,6,1,1,8
DEFAULT,23952,4,1,0,5
,,,,
STATION_GUY,48311,10,0,0,10
,,,,
GREEDY,39196,10,2,4,16
,,,,
GREEDY,25709,9,1,0,10
DEFAULT,25233,4,0,2,6
STATION_GUY,25881,6,0,2,8
,,,,
,,,,
,,,,
STATION_GUY,16443,4,0,4,8
GREEDY,20589,12,0,2,14
,,,,
,,,,
,,,,
,,,,
GREEDY,17837,10,1,1,12
,,,,
,,,,
DEFAULT,38531,8,1,0,9
GREEDY,41562,8,1,1,10
DEFAULT,73953,6,0,0,6
DEFAULT,27468,8,1,1,10
,,,,
,,,,
,,,,
,,,,
,,,,
GREEDY,30691,8,2,4,14
,,,,
,,,,
,,,,
,,,,
,,,,
,,,,
,,,,
,,,,
GREEDY,8426,8,1,3,12
,,,,
STATION_GUY,59940,5,0,0,5
,,,,
,,,,
,,,,
,,,,
STATION_GUY,56411,4,0,1,5
,,,,
STINGY,99913,2,0,0,2
GREEDY,67627,7,0,3,10
GREEDY,39726,10,1,0,11
,,,,
,,,,
,,,,
,,,,
,,,,
GREEDY,94978,11,0,1,12
GREEDY,31083,8,0,2,10
GREEDY,80046,7,1,4,12
DEFAULT,43348,6,0,0,6
GREEDY,25501,11,2,0,13
,,,,
,,,,
,,,,
GREEDY,37593,9,0,1,10
STATION_GUY,13822,4,0,2,6
,,,,
,,,,
DEFAULT,26770,5,0,3,8
GREEDY,94168,5,0,1,6
,,,,
,,,,
UTILITY_GUY,23317,5,1,2,8
,,,,
GREEDY,14175,10,0,3,13
,,,,
,,,,
,,,,
,,,,
,,,,
GREEDY,16466,8,1,0,9
,,,,
,,,,
,,,,
,,,,
UTILITY_GUY,64006,6,0,0,6
DEFAULT,90186,5,0,0,5
,,,,
UTILITY_GUY,63592,5,1,3,9
,,,,
UTILITY_GUY,60724,7,1,0,8
,,,,
,,,,
GREEDY,18896,8,0,2,10
,,,,
,,,,
,,,,
,,,,
UTILITY_GUY,22958,5,1,1,7
,,,,
,,,,
UTILITY_GUY,95069,8,0,0,8
,,,,
GREEDY,58952,9,0,1,10
GREEDY,24439,7,0,0,7
,,,,
,,,,
,,,,
,,,,
DEFAULT,52373,7,1,1,9
,,,,
,,,,
,,,,
,,,,
,,,,
,,,,
,,,,
STATION_GUY,42204,7,0,2,9
,,,,
GREEDY,24949,10,1,0,11
GREEDY,13051,6,2,0,8
GREEDY,27207,7,1,1,9
,,,,
DEFAULT,71476,6,0,1,7
UTILITY_GUY,91120,6,1,0,7
,,,,
,,,,
GREEDY,27049,9,1,1,11
,,,,
,,,,
DEFAULT,71018,5,0,1,6
GREEDY,14923,6,1,1,8
,,,,
,,,,
GREEDY,19760,10,0,1,11
GREEDY,24375,6,1,0,7
DEFAULT,66336,9,0,1,10
,,,,
DEFAULT,27589,7,1,1,9
,,,,
GREEDY,26386,9,0,0,9
,,,,
DEFAULT,48873,8,0,0,8
,,,,
,,,,
DEFAULT,43672,3,1,1,5
STATION_GUY,7690,4,1,4,9
GREEDY,68922,10,1,0,11
,,,,
GREEDY,90020,7,0,1,8
,,,,
,,,,
,,,,
,,,,
,,,,
,,,,
,,,,
GREEDY,20108,7,0,1,8
,,,,
,,,,
GREEDY,25818,5,2,0,7
,,,,
,,,,
STATION_GUY,12111,3,1,0,4
,,,,
,,,,
,,,,
,,,,
,,,,
,,,,
,,,,
,,,,
UTILITY_GUY,18375,5,1,0,6
UTILITY_GUY,18881,8,0,1,9
,,,,
GREEDY,30996,8,0,2,10
DEFAULT,25870,10,0,1,11
,,,,
,,,,
,,,,
,,,,
DEFAULT,97757,7,0,0,7
GREEDY,20060,8,0,2,10
GREEDY,11558,7,2,1,10
,,,,
GREEDY,17007,11,0,1,12
,,,,
GREEDY,24969,11,0,1,12
,,,,
,,,,
,,,,
STATION_GUY,9070,4,2,4,10
DEFAULT,40247,8,0,0,8
,,,,
,,,,
,,,,
,,,,
,,,,
,,,,
,,,,
,,,,
,,,,
UTILITY_GUY,52303,6,1,1,8
,,,,
STATION_GUY,39084,5,0,2,7
,,,,
,,,,
,,,,
,,,,
STATION_GUY,13288,9,0,4,13
,,,,
,,,,
GREEDY,48216,7,1,2,10
,,,,
GREEDY,78806,9,0,2,11
,,,,
,,,,
,,,,
GREEDY,21438,10,0,1,11
GREEDY,17054,9,0,1,10
GREEDY,15624,8,0,1,9
DEFAULT,72138,6,0,1,7
DEFAULT,60287,8,0,0,8
,,,,
GREEDY,14807,6,1,3,10
,,,,
,,,,
,,,,
,,,,
,,,,
DEFAULT,49045,9,1,0,10
GREEDY,22296,7,0,1,8
GREEDY,65349,8,0,0,8
,,,,
GREEDY,16944,10,1,0,11
,,,,
,,,,
,,,,
,,,,
GREEDY,17750,9,0,0,9
,,,,
,,,,
,,,,
STATION_GUY,23894,8,0,0,8
,,,,
,,,,
DEFAULT,35936,5,0,0,5
,,,,
,,,,
,,,,
,,,,
DEFAULT,15108,5,0,3,8
UTILITY_GUY,36836,7,0,0,7
,,,,
,,,,
,,,,
,,,,
,,,,
,,,,
,,,,
,,,,
,,,,
STATION_GUY,37887,7,0,1,8
,,,,
,,,,
,,,,
,,,,
DEFAULT,42789,8,0,0,8
,,,,
,,,,
,,,,
,,,,
,,,,
GREEDY,19953,8,1,2,11
GREEDY,68971,8,1,1,10
UTILITY_GUY,47907,4,2,0,6
,,,,
,,,,
,,,,
,,,,
,,,,
GREEDY,21570,9,2,2,13
,,,,
GREEDY,45157,9,0,2,11
,,,,
,,,,
GREEDY,19100,10,1,2,13
,,,,
,,,,
,,,,
STATION_GUY,42905,4,0,2,6
GREEDY,34646,11,1,1,13
GREEDY,16673,7,1,1,9
DEFAULT,37854,6,1,0,7
,,,,
,,,,
,,,,
,,,,
,,,,
GREEDY,15241,7,1,3,11
,,,,
,,,,
,,,,
GREEDY,13303,6,0,0,6
,,,,
,,,,
,,,,
,,,,
GREEDY,32289,10,0,0,10
,,,,
,,,,
,,,,
GREEDY,21661,9,0,0,9
GREEDY,15617,11,0,1,12
,,,,
,,,,
STATION_GUY,64815,7,0,2,9
,,,,
,,,,
,,,,
,,,,
,,,,
,,,,
,,,,
GREEDY,27692,9,0,0,9
,,,,
,,,,
,,,,
,,,,
,,,,
,,,,
,,,,
UTILITY_GUY,37971,8,1,0,9
,,,,
,,,,
,,,,
,,,,
GREEDY,18510,7,1,1,9
,,,,
UTILITY_GUY,45816,4,0,0,4
,,,,
STATION_GUY,41152,5,1,1,7
,,,,
,,,,
,,,,
,,,,
,,,,
DEFAULT,20114,7,0,1,8
GREEDY,34081,7,0,3,10
,,,,
,,,,
STATION_GUY,33191,5,0,1,6
,,,,
GREEDY,9125,8,2,2,12
,,,,
GREEDY,22039,10,0,1,11
,,,,
,,,,
,,,,
,,,,
GREEDY,14597,8,0,2,10
,,,,
,,,,
STATION_GUY,74744,8,0,0,8
,,,,
GREEDY,47493,12,0,0,12
DEFAULT,39223,4,0,1,5
,,,,
,,,,
,,,,
,,,,
DEFAULT,54909,6,1,4,11
DEFAULT,17788,8,0,1,9
,,,,
,,,,
,,,,
,,,,
,,,,
,,,,
,,,,
,,,,
STATION_GUY,31519,5,0,3,8
STATION_GUY,65592,7,0,0,7
,,,,
GREEDY,14043,10,1,3,14
GREEDY,23531,7,1,1,9
,,,,
UTILITY_GUY,22410,8,0,2,10
GREEDY,20185,6,0,1,7
GREEDY,57346,6,1,2,9
,,,,
,,,,
UTILITY_GUY,28249,6,2,0,8
GREEDY,11761,9,0,0,9
,,,,
,,,,
,,,,
GREEDY,28097,9,1,0,10
,,,,
GREEDY,12973,7,0,3,10
,,,,
,,,,
,,,,
,,,,
,,,,
,,,,
DEFAULT,47174,6,0,1,7
GREEDY,83555,9,2,0,11
UTILITY_GUY,21541,4,0,0,4
,,,,
DEFAULT,64133,2,0,1,3
,,,,
,,,,
,,,,
,,,,
,,,,
,,,,
,,,,
,,,,
,,,,
,,,,
GREEDY,18039,9,0,1,10
,,,,
,,,,
,,,,
,,,,
,,,,
,,,,
,,,,
,,,,
STATION_GUY,41551,5,1,2,8
DEFAULT,64036,6,0,1,7
,,,,
,,,,
STATION_GUY,44845,3,1,4,8
,,,,
,,,,
,,,,
,,,,
GREEDY,20894,6,0,2,8
,,,,
,,,,
,,,,
,,,,
,,,,
,,,,
,,,,
,,,,
,,,,
GREEDY,15717,8,0,3,11
,,,,
,,,,
,,,,
,,,,
,,,,
UTILITY_GUY,34951,6,1,0,7
,,,,
,,,,
,,,,
,,,,
,,,,
,,,,
,,,,
,,,,
GREEDY,20569,6,1,0,7
,,,,
,,,,
,,,,
,,,,
GREEDY,14473,10,1,1,12
,,,,
,,,,
GREEDY,20811,7,1,1,9
,,,,
GREEDY,32162,7,1,0,8
STATION_GUY,39908,8,1,2,11
UTILITY_GUY,50685,5,1,0,6
,,,,
,,,,
GREEDY,16007,10,0,0,10
,,,,
,,,,
GREEDY,19556,6,1,0,7
,,,,
,,,,
GREEDY,23109,8,1,0,9
,,,,
,,,,
GREEDY,25652,9,0,2,11
,,,,
,,,,
STATION_GUY,37310,5,0,1,6
GREEDY,30913,7,0,0,7
,,,,
,,,,
GREEDY,12958,10,1,0,11
STATION_GUY,54855,6,0,1,7
,,,,
UTILITY_GUY,35810,7,0,0,7
,,,,
,,,,
,,,,
,,,,
,,,,
GREEDY,22072,11,1,0,12
UTILITY_GUY,39020,6,0,2,8
,,,,
,,,,
DEFAULT,46110,7,0,1,8
,,,,
,,,,
,,,,
,,,,
STATION_GUY,28213,7,0,1,8
,,,,
DEFAULT,61841,6,0,1,7
,,,,
,,,,
,,,,
,,,,
,,,,
,,,,
DEFAULT,30755,7,0,1,8
,,,,
DEFAULT,61368,7,0,0,7
GREEDY,41504,9,1,1,11
GREEDY,16221,13,1,1,15
GREEDY,22055,7,1,1,9
,,,,
,,,,
,,,,
,,,,
,,,,
GREEDY,22899,11,2,1,14
,,,,
DEFAULT,41334,6,2,0,8
,,,,
,,,,
STATION_GUY,16288,8,1,0,9
DEFAULT,44150,7,0,1,8
GREEDY,24809,6,1,1,8
,,,,
,,,,
,,,,
,,,,
UTILITY_GUY,56580,9,1,0,10
GREEDY,40878,10,1,1,12
DEFAULT,47232,10,0,0,10
GREEDY,87674,7,0,0,7
GREEDY,24148,6,1,2,9
GREEDY,32412,9,0,0,9
GREEDY,51583,8,0,0,8
,,,,
,,,,
STATION_GUY,44405,8,0,1,9
,,,,
,,,,
,,,,
UTILITY_GUY,35682,9,1,0,10
,,,,
,,,,
,,,,
,,,,
DEFAULT,26201,3,0,1,4
,,,,
,,,,
,,,,
,,,,
,,,,
,,,,
GREEDY,24705,12,1,1,14
,,,,
,,,,
,,,,
DEFAULT,89362,8,1,1,10
,,,,
GREEDY,22381,9,1,2,12
,,,,
,,,,
,,,,
,,,,
,,,,
,,,,
GREEDY,19219,12,0,1,13
,,,,
,,,,
,,,,
STATION_GUY,93016,6,0,2,8
,,,,
GREEDY,9705,8,1,1,10
GREEDY,25161,6,1,0,7
,,,,
DEFAULT,11960,3,0,1,4
,,,,
,,,,
,,,,
,,,,
GREEDY,28038,8,1,2,11
GREEDY,10158,6,1,1,8
,,,,
,,,,
,,,,
,,,,
,,,,
STATION_GUY,12608,4,0,4,8
,,,,
,,,,
,,,,
,,,,
,,,,
,,,,
GREEDY,19322,6,1,0,7
UTILITY_GUY,48859,6,1,0,7
STATION_GUY,28163,5,1,4,10
,,,,
DEFAULT,24829,7,1,1,9
DEFAULT,44587,5,0,0,5
,,,,
,,,,
,,,,
GREEDY,26448,9,1,0,10
GREEDY,25107,9,0,1,10
STATION_GUY,24100,3,0,4,7
,,,,
,,,,
,,,,
DEFAULT,56916,8,0,0,8
GREEDY,63425,8,1,2,11
,,,,
,,,,
,,,,
,,,,
GREEDY,9243,8,0,3,11
,,,,
,,,,
,,,,
STATION_GUY,21033,5,0,2,7
,,,,
GREEDY,21877,7,0,1,8
,,,,
,,,,
,,,,
GREEDY,71331,8,0,0,8
,,,,
GREEDY,61525,7,0,0,7
,,,,
GREEDY,38915,7,1,2,10
,,,,
,,,,
,,,,
DEFAULT,51160,4,0,2,6
,,,,
GREEDY,22197,9,1,1,11
GREEDY,13925,6,1,0,7
,,,,
,,,,
,,,,
,,,,
,,,,
UTILITY_GUY,43210,4,0,2,6
,,,,
GREEDY,24699,9,0,1,10
,,,,
,,,,
,,,,
GREEDY,26008,13,0,0,13
,,,,
,,,,
GREEDY,18412,7,0,1,8
STATION_GUY,26672,8,0,2,10
GREEDY,14092,10,0,1,11
,,,,
,,,,
GREEDY,49796,8,0,4,12
,,,,
GREEDY,20378,9,1,3,13
GREEDY,20813,12,0,0,12
GREEDY,11127,8,0,0,8
UTILITY_GUY,42677,7,1,2,10
GREEDY,17703,10,0,0,10
DEFAULT,43014,5,0,1,6
,,,,
,,,,
,,,,
,,,,
GREEDY,41001,9,0,2,11
,,,,
,,,,
GREEDY,34210,10,0,2,12
,,,,
GREEDY,45975,11,0,2,13
,,,,
,,,,
,,,,
,,,,
,,,,
DEFAULT,40435,6,0,1,7
,,,,
GREEDY,38238,12,0,3,15
DEFAULT,13545,7,0,1,8
GREEDY,11580,6,0,0,6
,,,,
,,,,
,,,,
,,,,
UTILITY_GUY,30099,5,0,1,6
,,,,
DEFAULT,45628,9,0,0,9
,,,,
STATION_GUY,19748,4,0,2,6
,,,,
,,,,
,,,,
,,,,
UTILITY_GUY,60415,5,0,0,5
STATION_GUY,55385,8,1,3,12
,,,,
GREEDY,53164,9,0,2,11
,,,,
,,,,
GREEDY,15345,9,1,2,12
,,,,
GREEDY,20743,7,1,2,10
DEFAULT,95440,7,1,1,9
,,,,
GREEDY,35364,9,0,2,11
,,,,
,,,,
,,,,
,,,,
,,,,
STATION_GUY,45043,5,0,1,6
STATION_GUY,16870,5,0,1,6
GREEDY,25994,9,1,0,10
,,,,
,,,,
,,,,
,,,,
UTILITY_GUY,39880,4,2,0,6
DEFAULT,27557,6,0,0,6
,,,,
,,,,
,,,,
GREEDY,11835,6,2,1,9
,,,,
,,,,
,,,,
,,,,
GREEDY,22062,12,1,0,13
,,,,
,,,,
,,,,
GREEDY,19751,11,1,2,14
UTILITY_GUY,36653,4,1,0,5
,,,,
,,,,
,,,,
,,,,
STATION_GUY,31600,4,0,3,7
,,,,
GREEDY,19886,7,1,2,10
DEFAULT,25887,7,0,2,9
,,,,
,,,,
UTILITY_GUY,39103,6,1,0,7
,,,,
,,,,
,,,,
,,,,
,,,,
,,,,
STATION_GUY,18229,6,0,3,9
UTILITY_GUY,22850,5,1,1,7
GREEDY,24984,10,0,0,10
,,,,
,,,,
STATION_GUY,42805,4,1,1,6
,,,,
GREEDY,10839,8,0,0,8
,,,,
GREEDY,32933,9,0,1,10
,,,,
,,,,
,,,,
,,,,
GREEDY,62125,10,2,1,13
DEFAULT,52835,8,0,1,9
,,,,
,,,,
,,,,
,,,,
,,,,
,,,,
GREEDY,26445,8,1,1,10
UTILITY_GUY,51273,8,0,1,9
,,,,
,,,,
GREEDY,25387,7,0,0,7
DEFAULT,26733,7,0,1,8
,,,,
UTILITY_GUY,26320,6,0,0,6
,,,,
,,,,
DEFAULT,43803,5,0,0,5
,,,,
GREEDY,20090,9,0,2,11
,,,,
,,,,
,,,,
GREEDY,28077,7,0,1,8
DEFAULT,88323,9,0,1,10
,,,,
STATION_GUY,61643,4,1,2,7
GREEDY,9204,12,0,0,12
GREEDY,40215,8,2,2,12
GREEDY,21731,9,1,0,10
,,,,
,,,,
STINGY,83030,4,1,0,5
,,,,
,,,,
,,,,
,,,,
,,,,
,,,,
UTILITY_GUY,39633,5,0,1,6
GREEDY,19459,5,1,2,8
,,,,
DEFAULT,34053,4,0,1,5
,,,,
,,,,
GREEDY,82482,10,0,1,11
DEFAULT,38732,6,1,2,9
,,,,
,,,,
,,,,
,,,,
,,,,
,,,,
GREEDY,23768,7,1,2,10
,,,,
,,,,
,,,,
,,,,
,,,,
UTILITY_GUY,34896,4,0,1,5
UTILITY_GUY,49082,8,0,0,8
,,,,
,,,,
,,,,
,,,,
,,,,
GREEDY,19032,10,1,0,11
,,,,
,,,,
GREEDY,21277,8,1,1,10
,,,,
,,,,
GREEDY,16830,7,0,1,8
,,,,
GREEDY,14202,7,0,2,9
,,,,
,,,,
,,,,
,,,,
,,,,
,,,,
GREEDY,59741,10,1,1,12
,,,,
DEFAULT,50731,5,0,0,5
,,,,
DEFAULT,24653,3,1,0,4
UTILITY_GUY,32781,6,0,1,7
DEFAULT,45765,5,1,0,6
,,,,
GREEDY,28898,8,1,1,10
,,,,
,,,,
,,,,
GREEDY,19686,9,0,1,10
,,,,
,,,,
,,,,
,,,,
,,,,
,,,,
GREEDY,19327,10,1,1,12
GREEDY,59193,11,1,1,13
GREEDY,26095,7,0,1,8
,,,,
GREEDY,10598,10,0,2,12
,,,,
,,,,
GREEDY,28447,9,0,0,9
,,,,
,,,,
,,,,
DEFAULT,43470,6,1,0,7
,,,,
,,,,
,,,,
,,,,
,,,,
,,,,
UTILITY_GUY,31310,5,0,1,6
DEFAULT,42263,9,2,0,11
,,,,
GREEDY,29683,6,1,1,8
GREEDY,37252,7,0,0,7
,,,,
,,,,
,,,,
,,,,
,,,,
,,,,
STATION_GUY,37859,4,0,4,8
,,,,
,,,,
,,,,
DEFAULT,19745,4,0,1,5
,,,,
GREEDY,58442,7,0,3,10
,,,,
,,,,
,,,,
,,,,
,,,,
STATION_GUY,46751,7,1,1,9
,,,,
UTILITY_GUY,48529,7,0,0,7
,,,,
,,,,
,,,,
,,,,
,,,,
STATION_GUY,27828,4,0,1,5
,,,,
GREEDY,21831,11,1,1,13
,,,,
,,,,
GREEDY,14783,9,1,0,10
,,,,
,,,,
,,,,
UTILITY_GUY,66117,8,1,0,9
GREEDY,76518,13,1,1,15
,,,,
GREEDY,24607,6,1,0,7
,,,,
DEFAULT,29948,8,0,2,10
,,,,
GREEDY,28716,7,1,1,9
UTILITY_GUY,84661,5,0,1,6
,,,,
GREEDY,17532,10,1,3,14
,,,,
STATION_GUY,69970,5,1,1,7
GREEDY,53234,7,0,4,11
STATION_GUY,17042,5,0,4,9
,,,,
,,,,
,,,,
,,,,
,,,,
,,,,
UTILITY_GUY,38631,5,1,1,7
GREEDY,20273,7,0,0,7
,,,,
GREEDY,13284,7,0,2,9
,,,,
,,,,
UTILITY_GUY,31866,4,1,0,5
STATION_GUY,39178,7,0,0,7
,,,,
GREEDY,25253,9,0,2,11
,,,,
GREEDY,47992,8,1,1,10
GREEDY,15591,13,1,1,15
,,,,
,,,,
UTILITY_GUY,28159,7,1,1,9
GREEDY,44338,7,0,2,9
,,,,
,,,,
GREEDY,15285,11,0,0,11
STATION_GUY,30809,5,1,2,8
STATION_GUY,32404,5,0,1,6
,,,,
,,,,
,,,,
DEFAULT,32492,7,0,1,8
,,,,
,,,,
,,,,
,,,,
,,,,
,,,,
,,,,
,,,,
,,,,
STATION_GUY,67797,6,0,2,8
STATION_GUY,33605,6,0,1,7
,,,,
,,,,
,,,,
,,,,
,,,,
GREEDY,45872,10,1,1,12
GREEDY,13310,8,0,0,8
,,,,
,,,,
,,,,
,,,,
,,,,
,,,,
,,,,
,,,,
,,,,
UTILITY_GUY,38748,9,1,1,11
,,,,
GREEDY,99362,10,0,2,12
,,,,
,,,,
GREEDY,18714,10,0,0,10
,,,,
,,,,
,,,,
,,,,
,,,,
GREEDY,23892,9,0,1,10
,,,,
,,,,
,,,,
,,,,
DEFAULT,46180,6,0,1,7
STINGY,67112,4,0,0,4
,,,,
,,,,
,,,,
UTILITY_GUY,61633,5,1,0,6
GREEDY,23948,5,1,0,6
,,,,
UTILITY_GUY,20402,5,1,1,7
DEFAULT,26095,9,0,0,9
,,,,
,,,,
STATION_GUY,24030,4,1,1,6
GREEDY,22282,8,0,2,10
GREEDY,29193,9,1,2,12
,,,,
,,,,
,,,,
,,,,
GREEDY,8583,10,0,2,12
,,,,
UTILITY_GUY,30151,8,0,1,9
,,,,
DEFAULT,51463,9,0,0,9
DEFAULT,18791,4,1,0,5
STINGY,91450,3,0,1,4
,,,,
,,,,
,,,,
,,,,
,,,,
,,,,
,,,,
,,,,
DEFAULT,49270,7,0,1,8
DEFAULT,89793,7,1,1,9
,,,,
,,,,
,,,,
,,,,
,,,,
GREEDY,23166,10,0,1,11
,,,,
,,,,
,,,,
,,,,
,,,,
,,,,
UTILITY_GUY,50417,7,0,2,9
,,,,
GREEDY,24127,8,1,0,9
GREEDY,29695,12,1,1,14
,,,,
GREEDY,67627,9,2,1,12
,,,,
,,,,
GREEDY,24820,9,1,2,12
UTILITY_GUY,25108,5,1,0,6
,,,,
,,,,
GREEDY,19086,5,0,1,6
GREEDY,11464,7,2,1,10
GREEDY,24969,10,2,0,12
DEFAULT,33273,9,0,0,9
,,,,
,,,,
,,,,
,,,,
,,,,
,,,,
GREEDY,23372,7,1,2,10
,,,,
DEFAULT,36389,6,0,1,7
,,,,
GREEDY,16951,8,0,2,10
GREEDY,20505,7,2,1,10
GREEDY,23854,7,1,0,8
,,,,
GREEDY,19247,9,0,1,10
,,,,
GREEDY,18021,8,0,2,10
GREEDY,16375,6,1,2,9
,,,,
,,,,
,,,,
,,,,
,,,,
,,,,
,,,,
,,,,
,,,,
,,,,
DEFAULT,25610,6,0,1,7
GREEDY,15190,5,2,2,9
,,,,
,,,,
GREEDY,65847,10,1,1,12
,,,,
DEFAULT,43640,5,1,1,7
,,,,
,,,,
,,,,
,,,,
GREEDY,26201,8,0,0,8
GREEDY,94337,4,0,4,8
GREEDY,81771,10,1,1,12
,,,,
,,,,
,,,,
GREEDY,36167,8,2,1,11
UTILITY_GUY,50030,4,0,2,6
GREEDY,13213,7,2,2,11
UTILITY_GUY,15831,3,1,0,4
,,,,
GREEDY,15199,4,2,1,7
,,,,
,,,,
,,,,
,,,,
GREEDY,14194,8,1,1,10
DEFAULT,46714,4,0,1,5
,,,,
,,,,
,,,,
DEFAULT,39535,6,0,0,6
DEFAULT,34096,8,1,1,10
,,,,
,,,,
,,,,
GREEDY,9713,9,0,1,10
,,,,
,,,,
GREEDY,23468,9,1,3,13
,,,,
,,,,
UTILITY_GUY,51321,5,1,2,8
GREEDY,18538,10,0,1,11
GREEDY,27322,8,0,2,10
,,,,
,,,,
,,,,
GREEDY,19203,5,1,4,10
,,,,
,,,,
,,,,
GREEDY,82269,11,0,0,11
,,,,
GREEDY,24710,7,1,1,9
,,,,
,,,,
,,,,
GREEDY,30627,8,0,1,9
,,,,
,,,,
,,,,
,,,,
,,,,
GREEDY,61546,10,0,2,12
,,,,
,,,,
,,,,
DEFAULT,49739,7,1,1,9
,,,,
,,,,
,,,,
DEFAULT,59022,8,0,2,10
,,,,
,,,,
GREEDY,21713,9,0,1,10
GREEDY,59128,8,1,2,11
,,,,
,,,,
,,,,
UTILITY_GUY,58019,6,1,0,7
,,,,
,,,,
STATION_GUY,47716,6,1,1,8
,,,,
GREEDY,14861,9,1,1,11
GREEDY,23481,9,1,0,10
,,,,
,,,,
,,,,
,,,,
,,,,
,,,,
,,,,
GREEDY,10859,9,0,3,12
,,,,
,,,,
GREEDY,12241,6,0,3,9
,,,,
,,,,
,,,,
,,,,
,,,,
GREEDY,21085,7,0,1,8
STATION_GUY,37399,6,1,2,9
,,,,
GREEDY,22715,10,0,2,12
DEFAULT,76452,7,1,0,8
,,,,
STATION_GUY,64795,6,1,2,9
DEFAULT,32257,8,0,0,8
,,,,
STATION_GUY,17871,4,0,1,5
,,,,
GREEDY,23870,11,0,1,12
,,,,
GREEDY,14525,7,0,3,10
,,,,
GREEDY,37863,9,1,1,11
GREEDY,10820,7,0,3,10
,,,,
GREEDY,25840,7,0,1,8
,,,,
,,,,
,,,,
,,,,
GREEDY,27687,10,0,2,12
,,,,
,,,,
,,,,
DEFAULT,57456,7,0,1,8
,,,,
,,,,
,,,,
,,,,
,,,,
,,,,
,,,,
,,,,
,,,,
,,,,
,,,,
,,,,
,,,,
GREEDY,12535,9,0,2,11
DEFAULT,51064,8,1,1,10
,,,,
,,,,
,,,,
,,,,
,,,,
,,,,
GREEDY,14937,4,1,0,5
DEFAULT,29186,8,0,0,8
,,,,
,,,,
GREEDY,19810,4,0,1,5
GREEDY,29171,11,0,2,13
GREEDY,26863,9,0,1,10
,,,,
GREEDY,21877,12,1,2,15
,,,,
STATION_GUY,31436,4,0,0,4
GREEDY,24266,8,1,0,9
,,,,
,,,,
,,,,
,,,,
,,,,
STATION_GUY,33389,3,1,0,4
,,,,
,,,,
,,,,
,,,,
,,,,
,,,,
,,,,
DEFAULT,43224,8,0,2,10
,,,,
UTILITY_GUY,21514,5,0,0,5
,,,,
GREEDY,13129,7,0,1,8
GREEDY,23296,10,0,0,10
,,,,
,,,,
,,,,
,,,,
GREEDY,18175,7,1,0,8
GREEDY,78882,11,0,1,12
,,,,
,,,,
GREEDY,19180,7,1,1,9
,,,,
GREEDY,20143,9,0,1,10
GREEDY,58271,5,0,4,9
,,,,
GREEDY,27190,10,2,1,13
,,,,
,,,,
DEFAULT,56040,8,0,1,9
,,,,
,,,,
,,,,
,,,,
,,,,
,,,,
GREEDY,21182,11,1,0,12
DEFAULT,35030,9,0,0,9
,,,,
,,,,
GREEDY,70178,10,1,0,11
,,,,
,,,,
UTILITY_GUY,29770,7,1,1,9
UTILITY_GUY,82788,6,0,0,6
,,,,
,,,,
,,,,
STINGY,49963,4,0,1,5
,,,,
,,,,
,,,,
STATION_GUY,16598,3,2,1,6
,,,,
,,,,
,,,,
,,,,
GREEDY,42739,11,0,1,12
GREEDY,39098,10,1,1,12
,,,,
,,,,
STATION_GUY,35053,6,1,1,8
,,,,
,,,,
,,,,
GREEDY,16112,7,2,0,9
GREEDY,11624,10,0,2,12
STATION_GUY,93264,2,1,4,7
,,,,
,,,,
,,,,
,,,,
,,,,
GREEDY,41987,10,0,2,12
DEFAULT,64077,8,0,0,8
,,,,
STATION_GUY,44644,5,0,2,7
,,,,
GREEDY,27459,10,0,3,13
,,,,
,,,,
,,,,
GREEDY,23553,9,1,0,10
DEFAULT,22905,4,1,1,6
,,,,
GREEDY,19554,6,2,1,9
GREEDY,19337,8,0,1,9
UTILITY_GUY,42051,4,1,0,5
,,,,
GREEDY,27412,8,1,0,9
,,,,
,,,,
,,,,
,,,,
,,,,
,,,,
,,,,
,,,,
,,,,
,,,,
,,,,
GREEDY,23512,11,0,2,13
,,,,
,,,,
,,,,
,,,,
,,,,
,,,,
,,,,
,,,,
,,,,
,,,,
,,,,
,,,,
,,,,
DEFAULT,37571,7,1,2,10
,,,,
,,,,
,,,,
,,,,
,,,,
,,,,
,,,,
,,,,
,,,,
,,,,
,,,,
GREEDY,20058,7,0,0,7
,,,,
,,,,
,,,,
UTILITY_GUY,26359,3,1,3,7
GREEDY,72672,11,1,1,13
,,,,
,,,,
STATION_GUY,62522,10,0,0,10
,,,,
,,,,
,,,,
DEFAULT,56231,7,1,0,8
,,,,
UTILITY_GUY,50484,6,0,0,6
GREEDY,11531,5,2,2,9
,,,,
,,,,
STINGY,66634,6,0,0,6
,,,,
DEFAULT,47436,7,0,1,8
,,,,
GREEDY,18022,8,0,0,8
,,,,
,,,,
STATION_GUY,12981,3,0,4,7
,,,,
,,,,
,,,,
,,,,
,,,,
UTILITY_GUY,52379,6,1,0,7
,,,,
,,,,
,,,,
DEFAULT,50245,10,0,1,11
,,,,
,,,,
DEFAULT,28535,6,0,0,6
,,,,
,,,,
,,,,
,,,,
,,,,
,,,,
GREEDY,18789,7,0,2,9
,,,,
,,,,
GREEDY,23809,9,0,3,12
,,,,
,,,,
GREEDY,55586,10,0,0,10
GREEDY,32507,12,0,1,13
,,,,
,,,,
,,,,
GREEDY,69015,7,1,3,11
,,,,
,,,,
GREEDY,33657,7,1,4,12
STATION_GUY,36790,4,0,1,5
,,,,
,,,,
,,,,
,,,,
,,,,
UTILITY_GUY,25159,4,2,0,6
,,,,
GREEDY,28822,8,0,1,9
,,,,
STATION_GUY,14168,6,0,4,10
UTILITY_GUY,34062,7,1,0,8
GREEDY,29772,6,1,1,8
GREEDY,64809,9,2,2,13
,,,,
,,,,
,,,,
DEFAULT,33117,5,0,0,5
DEFAULT,64592,8,0,1,9
GREEDY,12739,13,1,1,15
DEFAULT,53058,6,1,0,7
,,,,
,,,,
,,,,
,,,,
,,,,
,,,,
,,,,
,,,,
GREEDY,19244,6,0,1,7
,,,,
,,,,
,,,,
,,,,
GREEDY,16308,7,1,1,9
,,,,
,,,,
,,,,
,,,,
,,,,
,,,,
GREEDY,31709,10,0,1,11
GREEDY,27637,8,1,1,10
,,,,
,,,,
DEFAULT,42076,3,1,1,5
DEFAULT,51951,9,0,2,11
GREEDY,22972,6,1,0,7
GREEDY,60772,9,0,1,10
,,,,
,,,,
GREEDY,21870,4,1,0,5
GREEDY,16761,11,1,1,13
,,,,
,,,,
,,,,
GREEDY,18988,8,2,0,10
,,,,
GREEDY,15924,8,0,1,9
GREEDY,27176,8,1,1,10
,,,,
UTILITY_GUY,68707,6,1,1,8
,,,,
STATION_GUY,51101,3,0,3,6
GREEDY,87716,3,1,4,8
,,,,
,,,,
,,,,
,,,,
GREEDY,37611,9,0,1,10
,,,,
UTILITY_GUY,52493,4,0,1,5
GREEDY,19043,7,2,0,9
,,,,
GREEDY,23183,10,1,0,11
,,,,
,,,,
,,,,
,,,,
DEFAULT,34934,9,1,0,10
GREEDY,16592,9,1,2,12
