strategy,money,countries,utilities,stations,totalLandsOwned
DEFAULT,72809,9,0,0,9
GREEDY,18413,7,1,3,11
,,,,
,,,,
DEFAULT,75125,6,1,0,7
,,,,
GREEDY,15994,9,0,0,9
,,,,
,,,,
,,,,
,,,,
,,,,
STINGY,30840,5,0,0,5
,,,,
GREEDY,23277,11,0,2,13
,,,,
,,,,
UTILITY_GUY,70334,10,1,0,11
DEFAULT,22891,6,1,1,8
UTILITY_GUY,86152,5,0,0,5
,,,,
,,,,
GREEDY,22794,12,1,0,13
,,,,
,,,,
,,,,
DEFAULT,79562,5,0,0,5
,,,,
,,,,
GREEDY,26996,7,0,0,7
,,,,
GREEDY,24233,9,1,0,10
,,,,
,,,,
,,,,
,,,,
,,,,
GREEDY,23688,10,0,0,10
,,,,
,,,,
,,,,
,,,,
,,,,
STATION_GUY,27091,6,0,0,6
,,,,
,,,,
,,,,
,,,,
,,,,
STATION_GUY,39509,5,1,0,6
,,,,
GREEDY,22444,12,0,0,12
,,,,
GREEDY,34256,10,0,0,10
,,,,
GREEDY,35114,10,1,0,11
GREEDY,11535,7,0,1,8
,,,,
,,,,
,,,,
GREEDY,83956,6,1,2,9
UTILITY_GUY,73951,6,0,1,7
,,,,
STATION_GUY,37364,4,1,4,9
GREEDY,37529,12,0,0,12
,,,,
,,,,
,,,,
GREEDY,75473,7,0,1,8
,,,,
,,,,
GREEDY,27562,10,2,0,12
GREEDY,18689,10,1,1,12
GREEDY,21174,7,0,1,8
,,,,
,,,,
,,,,
,,,,
,,,,
,,,,
,,,,
GREEDY,14406,11,0,0,11
,,,,
GREEDY,22359,9,1,2,12
,,,,
,,,,
,,,,
,,,,
,,,,
,,,,
GREEDY,24561,10,0,1,11
,,,,
,,,,
,,,,
DEFAULT,15762,5,0,1,6
GREEDY,18807,9,0,1,10
GREEDY,17693,9,0,2,11
,,,,
STATION_GUY,27927,4,0,0,4
GREEDY,13831,10,1,0,11
,,,,
,,,,
,,,,
,,,,
GREEDY,37159,8,0,0,8
,,,,
,,,,
,,,,
,,,,
GREEDY,22917,8,0,2,10
GREEDY,12909,9,0,0,9
GREEDY,39045,9,0,2,11
UTILITY_GUY,64957,6,0,0,6
,,,,
,,,,
,,,,
,,,,
UTILITY_GUY,41627,3,0,0,3
GREEDY,33064,8,1,1,10
,,,,
STATION_GUY,58108,4,0,1,5
,,,,
DEFAULT,54638,8,0,0,8
,,,,
,,,,
,,,,
GREEDY,13785,6,1,2,9
,,,,
,,,,
,,,,
,,,,
GREEDY,27007,10,0,0,10
DEFAULT,48936,5,1,1,7
,,,,
UTILITY_GUY,66396,6,1,0,7
,,,,
UTILITY_GUY,37584,5,0,1,6
,,,,
,,,,
,,,,
,,,,
,,,,
,,,,
,,,,
,,,,
STATION_GUY,20292,5,1,4,10
STATION_GUY,57876,3,0,1,4
,,,,
,,,,
,,,,
,,,,
GREEDY,32912,9,1,0,10
,,,,
,,,,
,,,,
,,,,
,,,,
,,,,
GREEDY,19263,12,0,1,13
,,,,
,,,,
,,,,
,,,,
STATION_GUY,28853,4,1,3,8
UTILITY_GUY,30800,8,1,0,9
,,,,
STATION_GUY,68745,7,0,0,7
,,,,
,,,,
,,,,
,,,,
,,,,
,,,,
GREEDY,11357,10,0,0,10
,,,,
STATION_GUY,74089,6,1,1,8
,,,,
GREEDY,41755,8,0,0,8
,,,,
STATION_GUY,26292,8,0,2,10
,,,,
GREEDY,16089,10,1,0,11
,,,,
GREEDY,45319,11,0,1,12
GREEDY,24223,7,0,2,9
GREEDY,25876,11,0,1,12
,,,,
,,,,
,,,,
,,,,
,,,,
,,,,
GREEDY,25180,8,0,1,9
,,,,
GREEDY,12263,10,0,1,11
,,,,
STATION_GUY,54932,7,1,1,9
,,,,
STATION_GUY,53610,7,1,0,8
,,,,
,,,,
,,,,
,,,,
,,,,
UTILITY_GUY,33853,3,0,0,3
UTILITY_GUY,42557,4,0,0,4
,,,,
DEFAULT,19127,7,1,0,8
,,,,
,,,,
,,,,
STATION_GUY,26411,5,0,3,8
DEFAULT,84716,5,0,1,6
,,,,
STATION_GUY,34505,5,0,3,8
,,,,
,,,,
,,,,
GREEDY,7651,7,0,0,7
UTILITY_GUY,52782,5,0,2,7
,,,,
,,,,
,,,,
DEFAULT,36331,6,0,1,7
,,,,
,,,,
,,,,
UTILITY_GUY,15510,4,2,2,8
,,,,
GREEDY,26601,7,0,2,9
,,,,
,,,,
,,,,
,,,,
STATION_GUY,39629,4,0,0,4
STATION_GUY,61801,4,0,3,7
,,,,
STATION_GUY,93556,5,0,2,7
,,,,
,,,,
,,,,
,,,,
GREEDY,18069,8,1,1,10
,,,,
UTILITY_GUY,25348,6,0,1,7
,,,,
,,,,
DEFAULT,19989,4,2,1,7
,,,,
,,,,
GREEDY,67082,6,0,1,7
GREEDY,69430,11,0,1,12
,,,,
,,,,
GREEDY,29746,8,1,2,11
,,,,
,,,,
STATION_GUY,35915,3,0,2,5
UTILITY_GUY,31462,4,0,1,5
,,,,
,,,,
GREEDY,20229,10,0,0,10
,,,,
GREEDY,29623,9,0,1,10
UTILITY_GUY,64766,6,1,0,7
,,,,
GREEDY,19623,8,1,1,10
,,,,
,,,,
,,,,
,,,,
GREEDY,24623,6,0,0,6
,,,,
,,,,
,,,,
STATION_GUY,15348,6,2,0,8
DEFAULT,60724,8,0,0,8
,,,,
DEFAULT,28755,9,0,0,9
,,,,
GREEDY,15485,6,0,0,6
GREEDY,31431,9,1,1,11
,,,,
,,,,
GREEDY,7784,11,0,0,11
,,,,
,,,,
GREEDY,18589,9,2,0,11
,,,,
,,,,
,,,,
,,,,
,,,,
,,,,
,,,,
,,,,
,,,,
,,,,
DEFAULT,13403,4,0,1,5
,,,,
GREEDY,23845,13,1,0,14
,,,,
UTILITY_GUY,41777,4,0,1,5
DEFAULT,51258,6,1,1,8
,,,,
DEFAULT,45201,5,0,0,5
,,,,
,,,,
STATION_GUY,33453,11,0,0,11
,,,,
,,,,
GREEDY,13596,9,0,0,9
,,,,
STATION_GUY,71775,5,0,1,6
,,,,
GREEDY,27994,7,1,2,10
GREEDY,20560,4,1,1,6
,,,,
,,,,
,,,,
,,,,
,,,,
GREEDY,28081,9,0,0,9
,,,,
,,,,
GREEDY,22954,7,0,0,7
,,,,
GREEDY,25453,12,0,0,12
,,,,
,,,,
,,,,
,,,,
UTILITY_GUY,34132,5,0,2,7
,,,,
,,,,
DEFAULT,46562,5,0,1,6
DEFAULT,59611,6,0,0,6
GREEDY,13664,9,0,1,10
STATION_GUY,59294,3,0,2,5
GREEDY,27694,8,0,2,10
GREEDY,17075,9,0,2,11
,,,,
,,,,
GREEDY,84709,8,0,0,8
DEFAULT,86217,7,0,1,8
,,,,
GREEDY,43457,9,0,0,9
,,,,
,,,,
DEFAULT,23362,8,0,1,9
GREEDY,37975,10,0,0,10
UTILITY_GUY,47314,5,0,0,5
,,,,
STATION_GUY,23182,0,1,4,5
,,,,
,,,,
,,,,
,,,,
STINGY,44733,4,0,2,6
GREEDY,29369,11,0,1,12
DEFAULT,46671,9,2,1,12
,,,,
,,,,
GREEDY,8552,6,1,0,7
,,,,
,,,,
,,,,
STATION_GUY,39119,6,0,1,7
,,,,
GREEDY,23321,5,0,0,5
GREEDY,68861,9,0,3,12
,,,,
GREEDY,15572,10,0,1,11
,,,,
,,,,
GREEDY,14530,8,1,1,10
,,,,
,,,,
GREEDY,29396,8,0,1,9
,,,,
GREEDY,30303,9,1,1,11
,,,,
GREEDY,37292,12,0,0,12
GREEDY,35816,9,0,2,11
,,,,
,,,,
,,,,
,,,,
,,,,
,,,,
,,,,
,,,,
,,,,
GREEDY,25262,9,1,2,12
,,,,
,,,,
,,,,
,,,,
,,,,
GREEDY,19677,5,1,3,9
,,,,
STATION_GUY,46012,4,1,1,6
STATION_GUY,90895,7,0,1,8
,,,,
GREEDY,19571,10,0,2,12
,,,,
,,,,
,,,,
,,,,
GREEDY,17185,7,0,3,10
,,,,
,,,,
GREEDY,12659,12,0,1,13
DEFAULT,85868,5,0,0,5
,,,,
,,,,
DEFAULT,16366,6,0,1,7
,,,,
,,,,
UTILITY_GUY,78588,4,0,0,4
,,,,
,,,,
,,,,
,,,,
,,,,
GREEDY,29992,11,1,0,12
DEFAULT,84685,7,0,1,8
GREEDY,29889,11,2,0,13
GREEDY,21311,9,0,2,11
,,,,
,,,,
,,,,
,,,,
,,,,
STATION_GUY,60407,5,1,1,7
DEFAULT,38047,4,0,1,5
GREEDY,39034,8,0,0,8
STATION_GUY,24889,4,0,4,8
,,,,
GREEDY,11399,7,0,1,8
,,,,
,,,,
,,,,
,,,,
,,,,
,,,,
STATION_GUY,75439,2,0,4,6
,,,,
,,,,
,,,,
,,,,
STATION_GUY,13088,3,1,3,7
,,,,
,,,,
,,,,
,,,,
,,,,
,,,,
,,,,
,,,,
,,,,
,,,,
GREEDY,18914,6,2,0,8
,,,,
,,,,
,,,,
,,,,
,,,,
GREEDY,31451,11,0,1,12
,,,,
,,,,
,,,,
,,,,
,,,,
,,,,
,,,,
,,,,
,,,,
DEFAULT,62347,7,1,1,9
,,,,
DEFAULT,73596,7,1,2,10
,,,,
GREEDY,33021,7,1,1,9
,,,,
,,,,
,,,,
,,,,
,,,,
,,,,
,,,,
,,,,
,,,,
,,,,
,,,,
,,,,
,,,,
GREEDY,24830,7,0,0,7
GREEDY,15339,7,0,1,8
GREEDY,36406,6,1,1,8
GREEDY,18463,7,0,1,8
,,,,
,,,,
,,,,
DEFAULT,48710,7,0,1,8
,,,,
GREEDY,90774,10,0,2,12
,,,,
,,,,
DEFAULT,45103,8,0,1,9
GREEDY,24872,7,1,0,8
,,,,
GREEDY,13831,9,0,2,11
,,,,
DEFAULT,72379,10,2,0,12
GREEDY,32212,7,1,1,9
,,,,
,,,,
,,,,
DEFAULT,28906,7,0,0,7
,,,,
GREEDY,24968,5,2,3,10
STATION_GUY,28890,4,0,4,8
DEFAULT,39385,6,0,2,8
,,,,
,,,,
GREEDY,32292,9,1,2,12
DEFAULT,82554,7,0,1,8
,,,,
UTILITY_GUY,33096,7,2,1,10
,,,,
,,,,
GREEDY,19480,6,1,1,8
GREEDY,22477,8,0,0,8
,,,,
,,,,
DEFAULT,19585,6,0,0,6
UTILITY_GUY,26600,7,2,0,9
,,,,
,,,,
,,,,
,,,,
GREEDY,27955,11,1,0,12
,,,,
,,,,
,,,,
,,,,
,,,,
GREEDY,42168,8,0,0,8
,,,,
,,,,
,,,,
,,,,
,,,,
GREEDY,15824,7,0,1,8
GREEDY,26965,9,0,2,11
GREEDY,21585,7,2,0,9
,,,,
,,,,
,,,,
,,,,
GREEDY,30116,11,0,1,12
,,,,
,,,,
GREEDY,9249,7,0,0,7
GREEDY,20219,10,0,1,11
,,,,
,,,,
,,,,
GREEDY,16090,8,1,3,12
,,,,
,,,,
DEFAULT,89834,6,0,2,8
,,,,
,,,,
,,,,
UTILITY_GUY,11152,7,0,1,8
DEFAULT,79828,5,1,1,7
,,,,
,,,,
,,,,
DEFAULT,40453,7,0,0,7
,,,,
GREEDY,14724,11,1,1,13
GREEDY,13452,9,0,0,9
STATION_GUY,56617,5,0,4,9
,,,,
,,,,
,,,,
,,,,
,,,,
UTILITY_GUY,37705,5,1,1,7
,,,,
GREEDY,35278,8,1,1,10
GREEDY,8533,6,1,4,11
GREEDY,19603,6,1,1,8
GREEDY,28164,8,0,1,9
,,,,
,,,,
,,,,
,,,,
GREEDY,19658,9,0,1,10
,,,,
,,,,
,,,,
,,,,
,,,,
,,,,
GREEDY,16796,7,0,3,10
,,,,
,,,,
,,,,
,,,,
GREEDY,11725,8,1,2,11
,,,,
,,,,
,,,,
GREEDY,20870,9,1,2,12
,,,,
,,,,
,,,,
DEFAULT,50960,6,0,0,6
,,,,
,,,,
UTILITY_GUY,80560,6,1,0,7
,,,,
,,,,
GREEDY,18784,10,2,0,12
,,,,
,,,,
GREEDY,14555,6,1,1,8
STATION_GUY,47173,7,1,0,8
,,,,
,,,,
,,,,
UTILITY_GUY,55705,7,0,1,8
STATION_GUY,69050,10,0,0,10
,,,,
,,,,
,,,,
,,,,
,,,,
GREEDY,20341,8,0,1,9
,,,,
,,,,
STATION_GUY,55601,2,0,4,6
,,,,
,,,,
,,,,
,,,,
DEFAULT,58983,6,1,0,7
GREEDY,24287,11,1,2,14
,,,,
,,,,
,,,,
GREEDY,17232,7,0,1,8
,,,,
,,,,
,,,,
DEFAULT,35871,7,0,0,7
GREEDY,19531,7,0,0,7
,,,,
,,,,
GREEDY,11424,11,0,0,11
,,,,
GREEDY,37407,9,0,0,9
DEFAULT,31745,6,0,0,6
,,,,
GREEDY,15145,9,1,2,12
,,,,
,,,,
GREEDY,26627,11,0,2,13
GREEDY,73880,7,0,2,9
DEFAULT,38158,11,1,0,12
,,,,
,,,,
DEFAULT,69688,8,1,0,9
DEFAULT,44486,7,0,1,8
,,,,
GREEDY,14786,10,0,0,10
GREEDY,60961,11,0,1,12
,,,,
,,,,
GREEDY,15097,6,1,0,7
,,,,
STATION_GUY,50219,7,0,1,8
,,,,
STATION_GUY,71809,10,0,2,12
STATION_GUY,51267,7,0,1,8
,,,,
,,,,
,,,,
,,,,
,,,,
GREEDY,14804,10,0,2,12
,,,,
,,,,
,,,,
GREEDY,20876,10,1,2,13
,,,,
,,,,
,,,,
,,,,
,,,,
,,,,
,,,,
DEFAULT,20766,10,0,0,10
,,,,
GREEDY,19462,9,0,2,11
DEFAULT,46789,4,0,1,5
GREEDY,20883,6,1,3,10
,,,,
DEFAULT,49977,4,0,1,5
,,,,
,,,,
STATION_GUY,14301,7,1,1,9
,,,,
,,,,
,,,,
,,,,
,,,,
GREEDY,12939,11,0,0,11
,,,,
,,,,
STATION_GUY,53205,7,0,0,7
GREEDY,27855,9,1,0,10
,,,,
,,,,
UTILITY_GUY,33779,3,1,0,4
,,,,
GREEDY,20389,8,0,0,8
,,,,
,,,,
,,,,
,,,,
GREEDY,25218,8,0,0,8
,,,,
,,,,
GREEDY,16527,9,0,1,10
,,,,
,,,,
GREEDY,30193,8,1,1,10
,,,,
GREEDY,28911,7,1,1,9
,,,,
,,,,
,,,,
GREEDY,29470,11,1,2,14
,,,,
GREEDY,15300,9,0,1,10
GREEDY,19628,9,0,2,11
,,,,
,,,,
,,,,
,,,,
,,,,
,,,,
,,,,
,,,,
,,,,
GREEDY,16775,7,2,1,10
,,,,
,,,,
GREEDY,13047,6,1,1,8
,,,,
,,,,
,,,,
,,,,
UTILITY_GUY,37087,5,0,2,7
,,,,
GREEDY,32080,8,2,0,10
STATION_GUY,47581,4,0,3,7
GREEDY,30272,13,0,2,15
GREEDY,9353,6,0,1,7
,,,,
,,,,
,,,,
GREEDY,11151,13,1,1,15
UTILITY_GUY,83957,7,2,1,10
,,,,
DEFAULT,70281,7,0,0,7
,,,,
,,,,
,,,,
,,,,
GREEDY,76709,8,0,2,10
STATION_GUY,49374,4,0,1,5
,,,,
,,,,
,,,,
STATION_GUY,49895,6,0,3,9
,,,,
GREEDY,24377,7,1,1,9
,,,,
,,,,
GREEDY,29204,10,0,1,11
,,,,
DEFAULT,59035,5,0,1,6
,,,,
STATION_GUY,35386,7,1,2,10
GREEDY,26215,9,2,2,13
,,,,
STATION_GUY,31214,4,1,1,6
GREEDY,48898,10,0,3,13
,,,,
GREEDY,37398,7,1,1,9
,,,,
,,,,
,,,,
,,,,
,,,,
,,,,
GREEDY,55111,11,0,0,11
,,,,
,,,,
UTILITY_GUY,20448,5,0,1,6
,,,,
,,,,
GREEDY,13842,10,0,2,12
,,,,
,,,,
DEFAULT,15530,6,0,3,9
,,,,
,,,,
DEFAULT,76142,10,0,0,10
UTILITY_GUY,76680,6,1,1,8
,,,,
,,,,
,,,,
,,,,
,,,,
,,,,
,,,,
,,,,
GREEDY,20698,9,0,0,9
UTILITY_GUY,42911,7,0,2,9
GREEDY,30863,10,1,1,12
,,,,
,,,,
GREEDY,29430,8,0,2,10
,,,,
GREEDY,23931,10,1,0,11
,,,,
,,,,
,,,,
DEFAULT,40027,6,1,1,8
,,,,
,,,,
GREEDY,19175,8,1,0,9
,,,,
,,,,
GREEDY,45717,11,0,2,13
GREEDY,25930,7,0,0,7
GREEDY,12868,11,0,1,12
,,,,
,,,,
DEFAULT,37851,7,0,1,8
,,,,
,,,,
,,,,
STATION_GUY,47933,5,0,1,6
,,,,
,,,,
,,,,
,,,,
UTILITY_GUY,31271,7,2,0,9
,,,,
,,,,
,,,,
,,,,
,,,,
,,,,
GREEDY,23496,9,1,0,10
,,,,
,,,,
GREEDY,28569,10,2,1,13
,,,,
GREEDY,15418,9,0,2,11
,,,,
,,,,
,,,,
UTILITY_GUY,22891,6,0,1,7
,,,,
GREEDY,15612,10,0,0,10
STATION_GUY,57266,4,0,2,6
,,,,
,,,,
GREEDY,13513,9,0,3,12
,,,,
GREEDY,24156,10,1,0,11
,,,,
,,,,
GREEDY,21506,9,0,0,9
,,,,
,,,,
,,,,
,,,,
,,,,
,,,,
,,,,
GREEDY,25562,8,0,0,8
,,,,
,,,,
,,,,
,,,,
,,,,
,,,,
GREEDY,13995,9,1,0,10
GREEDY,23722,8,1,0,9
,,,,
DEFAULT,51707,5,1,1,7
,,,,
GREEDY,23323,8,0,0,8
,,,,
,,,,
DEFAULT,60580,9,0,0,9
,,,,
STATION_GUY,18613,6,0,2,8
DEFAULT,33408,8,0,0,8
,,,,
,,,,
,,,,
,,,,
,,,,
,,,,
DEFAULT,37598,7,1,1,9
UTILITY_GUY,31704,8,1,2,11
,,,,
DEFAULT,55420,8,0,1,9
,,,,
,,,,
,,,,
,,,,
GREEDY,12752,10,0,2,12
DEFAULT,69660,4,0,1,5
GREEDY,40228,11,0,0,11
,,,,
GREEDY,17399,8,0,1,9
STATION_GUY,7558,1,0,4,5
,,,,
DEFAULT,27047,7,0,3,10
STATION_GUY,40191,5,0,1,6
,,,,
GREEDY,67362,7,1,4,12
GREEDY,29249,8,0,2,10
,,,,
DEFAULT,40946,9,0,1,10
,,,,
,,,,
,,,,
DEFAULT,26210,7,1,0,8
,,,,
DEFAULT,19495,6,0,0,6
STATION_GUY,26096,5,1,0,6
,,,,
STATION_GUY,69112,5,1,2,8
,,,,
,,,,
,,,,
STATION_GUY,11283,3,0,4,7
,,,,
GREEDY,9734,12,1,0,13
GREEDY,10733,9,0,4,13
GREEDY,24840,9,0,1,10
,,,,
,,,,
,,,,
STATION_GUY,92615,3,1,4,8
,,,,
,,,,
,,,,
DEFAULT,58142,7,1,1,9
,,,,
GREEDY,17122,8,1,1,10
GREEDY,20617,12,1,2,15
GREEDY,21655,5,0,2,7
,,,,
,,,,
,,,,
,,,,
GREEDY,76070,10,0,1,11
STATION_GUY,72978,8,0,2,10
GREEDY,58738,11,1,0,12
,,,,
,,,,
,,,,
,,,,
,,,,
GREEDY,17435,11,0,0,11
,,,,
,,,,
STATION_GUY,22746,4,0,4,8
,,,,
,,,,
GREEDY,21252,6,1,2,9
,,,,
,,,,
,,,,
,,,,
,,,,
,,,,
GREEDY,72706,10,1,1,12
GREEDY,35072,10,0,0,10
,,,,
,,,,
,,,,
DEFAULT,64633,5,0,2,7
,,,,
,,,,
,,,,
,,,,
,,,,
,,,,
,,,,
,,,,
,,,,
DEFAULT,38050,5,0,2,7
,,,,
,,,,
,,,,
,,,,
,,,,
,,,,
UTILITY_GUY,31065,4,2,2,8
,,,,
,,,,
,,,,
DEFAULT,48381,6,0,0,6
GREEDY,14815,8,0,2,10
,,,,
DEFAULT,37980,7,1,0,8
,,,,
,,,,
GREEDY,77611,6,0,1,7
DEFAULT,27286,10,0,1,11
,,,,
,,,,
UTILITY_GUY,46458,7,1,0,8
GREEDY,10897,9,1,1,11
,,,,
,,,,
GREEDY,17533,8,0,1,9
,,,,
GREEDY,30336,7,0,2,9
,,,,
,,,,
,,,,
,,,,
,,,,
STATION_GUY,80772,3,0,3,6
,,,,
,,,,
,,,,
,,,,
DEFAULT,45141,6,0,1,7
,,,,
GREEDY,21156,14,0,3,17
,,,,
,,,,
,,,,
GREEDY,27116,10,0,1,11
,,,,
STATION_GUY,32381,8,0,4,12
GREEDY,14896,11,1,2,14
,,,,
,,,,
,,,,
GREEDY,29626,9,0,3,12
,,,,
GREEDY,16968,7,1,0,8
,,,,
,,,,
DEFAULT,41972,8,0,0,8
,,,,
,,,,
,,,,
,,,,
DEFAULT,25299,5,1,0,6
GREEDY,14293,8,1,2,11
GREEDY,20899,9,2,1,12
STATION_GUY,75145,4,0,0,4
,,,,
,,,,
STATION_GUY,65385,9,1,1,11
GREEDY,19662,11,1,1,13
GREEDY,30346,7,0,1,8
GREEDY,33337,5,1,1,7
UTILITY_GUY,34312,5,0,0,5
GREEDY,20030,6,0,1,7
,,,,
DEFAULT,93522,7,0,0,7
,,,,
DEFAULT,56986,4,0,1,5
,,,,
,,,,
GREEDY,20014,11,2,0,13
,,,,
GREEDY,16598,10,0,0,10
STATION_GUY,28080,6,0,1,7
,,,,
STATION_GUY,33573,5,1,1,7
STATION_GUY,51863,3,2,2,7
,,,,
,,,,
,,,,
,,,,
,,,,
DEFAULT,19984,6,0,1,7
,,,,
,,,,
,,,,
,,,,
DEFAULT,45371,8,0,0,8
,,,,
,,,,
,,,,
,,,,
GREEDY,9342,7,0,0,7
,,,,
GREEDY,16403,9,1,1,11
GREEDY,21238,10,1,1,12
,,,,
,,,,
GREEDY,24103,12,1,1,14
,,,,
,,,,
,,,,
GREEDY,24804,8,0,2,10
GREEDY,23930,10,1,0,11
STATION_GUY,42718,4,1,2,7
,,,,
,,,,
,,,,
,,,,
,,,,
,,,,
,,,,
,,,,
DEFAULT,73590,11,0,0,11
,,,,
,,,,
,,,,
GREEDY,26136,7,0,0,7
GREEDY,19931,8,1,2,11
GREEDY,20213,11,1,1,13
,,,,
,,,,
UTILITY_GUY,34856,5,0,1,6
,,,,
GREEDY,35416,11,0,2,13
,,,,
,,,,
,,,,
,,,,
GREEDY,20972,8,0,2,10
,,,,
,,,,
,,,,
,,,,
,,,,
,,,,
GREEDY,20926,12,0,1,13
,,,,
,,,,
,,,,
DEFAULT,30969,4,1,1,6
UTILITY_GUY,34022,4,1,2,7
,,,,
DEFAULT,50071,6,1,0,7
GREEDY,21157,7,1,3,11
,,,,
,,,,
,,,,
,,,,
,,,,
DEFAULT,56140,6,0,0,6
,,,,
,,,,
,,,,
STATION_GUY,46105,6,1,0,7
,,,,
,,,,
,,,,
DEFAULT,27787,8,1,1,10
DEFAULT,45622,7,0,1,8
,,,,
,,,,
,,,,
,,,,
,,,,
GREEDY,31905,7,0,0,7
,,,,
DEFAULT,33846,5,1,1,7
,,,,
DEFAULT,27002,6,0,0,6
,,,,
,,,,
GREEDY,29214,7,0,2,9
GREEDY,30143,11,1,0,12
GREEDY,41410,8,0,1,9
DEFAULT,19463,5,0,2,7
,,,,
GREEDY,30609,10,2,2,14
,,,,
DEFAULT,79483,6,0,1,7
,,,,
DEFAULT,44986,7,1,0,8
,,,,
,,,,
GREEDY,22685,11,0,0,11
,,,,
,,,,
GREEDY,13989,11,2,0,13
,,,,
GREEDY,26461,8,0,1,9
,,,,
,,,,
,,,,
,,,,
,,,,
,,,,
,,,,
,,,,
DEFAULT,23711,7,0,2,9
,,,,
,,,,
,,,,
STATION_GUY,21809,5,1,4,10
,,,,
,,,,
,,,,
,,,,
GREEDY,78186,8,1,1,10
,,,,
,,,,
GREEDY,50208,10,0,0,10
,,,,
,,,,
,,,,
,,,,
STATION_GUY,57250,5,2,2,9
,,,,
,,,,
,,,,
,,,,
,,,,
GREEDY,15222,6,1,1,8
,,,,
,,,,
GREEDY,18349,10,0,1,11
,,,,
GREEDY,19542,9,0,0,9
,,,,
,,,,
,,,,
DEFAULT,25189,8,0,1,9
UTILITY_GUY,19483,2,1,1,4
UTILITY_GUY,44749,4,0,0,4
,,,,
UTILITY_GUY,84728,2,1,1,4
GREEDY,22700,10,0,0,10
,,,,
,,,,
GREEDY,37284,9,1,3,13
GREEDY,29749,10,1,3,14
,,,,
STATION_GUY,59063,8,0,1,9
UTILITY_GUY,82520,5,0,1,6
,,,,
,,,,
,,,,
GREEDY,12608,10,1,0,11
,,,,
,,,,
,,,,
,,,,
GREEDY,46406,11,0,2,13
,,,,
DEFAULT,30577,7,0,1,8
DEFAULT,45195,6,0,2,8
GREEDY,41578,8,1,1,10
,,,,
GREEDY,24193,8,0,1,9
,,,,
,,,,
,,,,
,,,,
DEFAULT,42177,6,1,1,8
GREEDY,15902,9,0,0,9
,,,,
,,,,
STATION_GUY,33309,5,1,1,7
UTILITY_GUY,18379,6,0,2,8
UTILITY_GUY,31658,7,1,1,9
,,,,
GREEDY,25632,8,2,1,11
,,,,
DEFAULT,51069,5,0,0,5
,,,,
,,,,
GREEDY,15820,11,0,0,11
GREEDY,75818,9,0,2,11
,,,,
,,,,
,,,,
,,,,
,,,,
DEFAULT,40882,6,0,0,6
,,,,
GREEDY,28587,9,0,0,9
,,,,
,,,,
DEFAULT,50983,4,1,2,7
UTILITY_GUY,63679,7,0,0,7
UTILITY_GUY,68972,8,1,0,9
,,,,
STATION_GUY,65390,5,1,3,9
,,,,
GREEDY,14506,8,0,2,10
,,,,
,,,,
,,,,
UTILITY_GUY,24505,6,0,2,8
,,,,
,,,,
,,,,
,,,,
,,,,
,,,,
,,,,
GREEDY,28843,12,0,1,13
,,,,
UTILITY_GUY,27188,5,0,1,6
UTILITY_GUY,50377,4,1,0,5
,,,,
,,,,
GREEDY,27677,6,1,1,8
,,,,
,,,,
,,,,
GREEDY,14557,4,2,1,7
GREEDY,14537,7,0,0,7
STATION_GUY,51257,6,1,0,7
GREEDY,39776,8,1,0,9
,,,,
,,,,
GREEDY,29057,6,0,0,6
GREEDY,36123,8,1,0,9
GREEDY,18942,8,1,0,9
,,,,
,,,,
,,,,
,,,,
UTILITY_GUY,45358,9,1,0,10
GREEDY,24273,8,0,1,9
GREEDY,18571,10,0,1,11
,,,,
GREEDY,17839,11,2,2,15
,,,,
,,,,
,,,,
,,,,
,,,,
GREEDY,24553,8,1,2,11
,,,,
GREEDY,28333,10,0,0,10
,,,,
UTILITY_GUY,50711,7,0,0,7
,,,,
GREEDY,17978,10,1,0,11
,,,,
GREEDY,12647,8,1,0,9
DEFAULT,34084,8,0,1,9
GREEDY,18766,13,0,1,14
STATION_GUY,35299,6,0,0,6
,,,,
,,,,
,,,,
,,,,
,,,,
GREEDY,18584,6,2,2,10
,,,,
GREEDY,12527,8,0,0,8
,,,,
,,,,
GREEDY,15969,9,0,2,11
,,,,
DEFAULT,53795,6,0,0,6
,,,,
,,,,
,,,,
STINGY,80464,3,0,0,3
GREEDY,20877,7,0,1,8
,,,,
GREEDY,44345,8,0,1,9
DEFAULT,75349,6,1,0,7
,,,,
,,,,
,,,,
STATION_GUY,30805,6,0,3,9
DEFAULT,42951,7,0,2,9
,,,,
,,,,
,,,,
,,,,
,,,,
,,,,
,,,,
,,,,
,,,,
,,,,
DEFAULT,37887,7,0,0,7
GREEDY,26601,10,0,1,11
UTILITY_GUY,26264,5,0,1,6
GREEDY,11695,7,0,3,10
,,,,
GREEDY,12453,8,0,3,11
,,,,
GREEDY,16334,10,1,0,11
,,,,
,,,,
DEFAULT,45652,6,0,0,6
UTILITY_GUY,21259,5,2,2,9
STATION_GUY,40210,5,0,3,8
GREEDY,42295,10,0,1,11
DEFAULT,43690,6,0,0,6
GREEDY,24723,7,2,0,9
,,,,
,,,,
,,,,
,,,,
GREEDY,25808,6,0,2,8
,,,,
,,,,
,,,,
GREEDY,23351,6,1,2,9
,,,,
,,,,
,,,,
,,,,
,,,,
,,,,
GREEDY,16272,7,0,0,7
GREEDY,29990,9,0,1,10
,,,,
,,,,
,,,,
,,,,
,,,,
,,,,
,,,,
GREEDY,16919,9,0,2,11
GREEDY,21670,9,1,2,12
,,,,
,,,,
,,,,
STATION_GUY,17560,5,0,2,7
,,,,
,,,,
DEFAULT,63000,5,1,0,6
,,,,
,,,,
,,,,
,,,,
,,,,
GREEDY,16013,9,0,2,11
,,,,
DEFAULT,76504,6,1,2,9
,,,,
,,,,
,,,,
,,,,
GREEDY,43179,7,1,2,10
GREEDY,11205,7,0,2,9
UTILITY_GUY,46080,4,1,2,7
,,,,
,,,,
,,,,
STATION_GUY,23983,6,0,0,6
,,,,
,,,,
DEFAULT,40271,5,1,0,6
GREEDY,29321,8,0,1,9
STATION_GUY,43336,5,2,2,9
,,,,
,,,,
STATION_GUY,51371,5,0,2,7
GREEDY,33709,9,1,1,11
,,,,
,,,,
GREEDY,29513,6,1,1,8
,,,,
GREEDY,13198,9,0,0,9
DEFAULT,34601,6,0,0,6
,,,,
DEFAULT,12497,6,0,1,7
,,,,
GREEDY,20667,7,0,0,7
,,,,
GREEDY,28381,8,1,0,9
UTILITY_GUY,40175,4,0,0,4
,,,,
,,,,
,,,,
UTILITY_GUY,15036,5,0,2,7
,,,,
,,,,
,,,,
,,,,
,,,,
,,,,
,,,,
,,,,
GREEDY,15429,10,0,0,10
DEFAULT,58261,6,0,0,6
,,,,
,,,,
GREEDY,27901,6,0,2,8
,,,,
,,,,
,,,,
GREEDY,11801,7,1,0,8
GREEDY,39020,6,0,1,7
,,,,
GREEDY,21684,11,0,0,11
,,,,
GREEDY,19444,10,0,0,10
,,,,
,,,,
,,,,
,,,,
,,,,
,,,,
,,,,
,,,,
GREEDY,23642,10,1,1,12
,,,,
GREEDY,13023,9,0,2,11
,,,,
,,,,
,,,,
,,,,
GREEDY,22691,8,1,2,11
,,,,
,,,,
,,,,
GREEDY,19595,9,0,1,10
,,,,
,,,,
,,,,
,,,,
,,,,
GREEDY,13569,7,2,0,9
,,,,
,,,,
,,,,
,,,,
GREEDY,26890,7,0,0,7
GREEDY,32980,10,0,0,10
,,,,
STATION_GUY,31007,2,0,4,6
,,,,
,,,,
,,,,
,,,,
STATION_GUY,73877,4,0,1,5
,,,,
,,,,
DEFAULT,56611,6,0,2,8
GREEDY,20077,13,0,0,13
,,,,
,,,,
,,,,
DEFAULT,80834,7,0,0,7
STINGY,68713,6,0,0,6
DEFAULT,19738,5,1,2,8
,,,,
GREEDY,10094,8,0,1,9
,,,,
,,,,
DEFAULT,55592,8,0,0,8
,,,,
,,,,
,,,,
,,,,
GREEDY,23544,8,2,0,10
GREEDY,11654,9,1,1,11
,,,,
DEFAULT,69252,6,0,1,7
,,,,
,,,,
,,,,
,,,,
,,,,
,,,,
GREEDY,24092,6,1,0,7
,,,,
UTILITY_GUY,46591,12,0,0,12
STATION_GUY,55098,8,1,1,10
,,,,
,,,,
,,,,
,,,,
,,,,
,,,,
,,,,
,,,,
,,,,
,,,,
,,,,
,,,,
GREEDY,24758,9,0,1,10
,,,,
,,,,
,,,,
GREEDY,47877,9,1,1,11
,,,,
,,,,
,,,,
GREEDY,15307,9,1,0,10
,,,,
GREEDY,60039,6,0,4,10
,,,,
,,,,
,,,,
,,,,
GREEDY,35822,6,0,1,7
,,,,
GREEDY,34014,9,0,2,11
,,,,
,,,,
DEFAULT,26517,6,1,1,8
,,,,
,,,,
,,,,
,,,,
,,,,
,,,,
,,,,
,,,,
,,,,
STATION_GUY,43416,3,0,3,6
,,,,
,,,,
DEFAULT,78754,11,0,0,11
UTILITY_GUY,97191,9,0,0,9
,,,,
,,,,
,,,,
,,,,
,,,,
,,,,
,,,,
DEFAULT,46702,6,0,1,7
,,,,
GREEDY,43897,10,0,0,10
GREEDY,19354,9,0,1,10
,,,,
,,,,
GREEDY,35877,9,1,0,10
,,,,
,,,,
,,,,
,,,,
,,,,
STATION_GUY,43275,6,0,1,7
,,,,
GREEDY,35511,7,0,3,10
GREEDY,51196,6,1,1,8
,,,,
STATION_GUY,70797,3,0,1,4
GREEDY,14902,4,1,0,5
,,,,
,,,,
,,,,
GREEDY,13236,10,0,2,12
,,,,
,,,,
DEFAULT,28444,8,1,0,9
STINGY,66753,5,0,0,5
,,,,
,,,,
,,,,
,,,,
,,,,
,,,,
DEFAULT,23390,4,1,0,5
GREEDY,25577,13,0,1,14
,,,,
,,,,
,,,,
,,,,
UTILITY_GUY,20332,5,0,0,5
,,,,
,,,,
GREEDY,24044,11,1,0,12
,,,,
GREEDY,19113,9,0,0,9
,,,,
GREEDY,35762,7,1,1,9
GREEDY,16016,8,1,1,10
,,,,
,,,,
DEFAULT,85257,6,0,1,7
,,,,
,,,,
,,,,
,,,,
,,,,
,,,,
,,,,
GREEDY,89020,7,2,0,9
,,,,
STATION_GUY,15258,2,0,4,6
GREEDY,19277,9,0,1,10
,,,,
,,,,
,,,,
DEFAULT,21061,6,0,1,7
GREEDY,31940,8,0,1,9
,,,,
GREEDY,16353,9,1,1,11
,,,,
,,,,
,,,,
,,,,
GREEDY,23370,9,0,1,10
UTILITY_GUY,54167,2,1,4,7
,,,,
,,,,
GREEDY,23701,7,0,0,7
,,,,
,,,,
GREEDY,19470,10,0,0,10
,,,,
,,,,
,,,,
DEFAULT,34999,5,0,1,6
GREEDY,53976,8,0,0,8
,,,,
STATION_GUY,81708,7,0,0,7
GREEDY,13781,4,0,1,5
,,,,
DEFAULT,36292,7,1,1,9
,,,,
,,,,
GREEDY,15089,10,2,2,14
,,,,
DEFAULT,96635,6,0,1,7
,,,,
,,,,
,,,,
,,,,
GREEDY,39591,12,1,1,14
,,,,
STATION_GUY,38858,6,0,2,8
,,,,
DEFAULT,51641,2,0,3,5
DEFAULT,33722,8,0,0,8
,,,,
,,,,
,,,,
,,,,
,,,,
,,,,
,,,,
DEFAULT,59489,6,0,1,7
,,,,
,,,,
,,,,
,,,,
,,,,
,,,,
,,,,
,,,,
,,,,
UTILITY_GUY,36963,5,0,1,6
GREEDY,18535,7,0,2,9
,,,,
,,,,
,,,,
,,,,
,,,,
,,,,
,,,,
,,,,
GREEDY,29808,7,1,3,11
STINGY,92894,4,0,0,4
GREEDY,79367,8,0,1,9
,,,,
GREEDY,27668,9,1,1,11
,,,,
,,,,
,,,,
STATION_GUY,22436,6,0,0,6
DEFAULT,22181,6,1,0,7
,,,,
STATION_GUY,69911,6,0,2,8
,,,,
GREEDY,26815,8,1,0,9
,,,,
DEFAULT,23568,7,0,2,9
,,,,
,,,,
GREEDY,70264,8,2,4,14
UTILITY_GUY,59248,7,0,0,7
GREEDY,16259,10,0,2,12
,,,,
STATION_GUY,43457,6,0,1,7
GREEDY,56754,9,1,1,11
,,,,
,,,,
GREEDY,22791,9,0,0,9
,,,,
DEFAULT,28653,8,0,0,8
DEFAULT,96504,3,1,1,5
,,,,
,,,,
GREEDY,20488,10,0,0,10
,,,,
GREEDY,20863,8,1,1,10
,,,,
DEFAULT,31882,6,0,2,8
,,,,
,,,,
,,,,
STATION_GUY,66257,5,0,2,7
UTILITY_GUY,46915,4,0,1,5
,,,,
DEFAULT,47220,6,0,1,7
,,,,
,,,,
GREEDY,56000,10,0,3,13
DEFAULT,31098,6,0,2,8
,,,,
,,,,
,,,,
GREEDY,37668,8,0,1,9
,,,,
,,,,
,,,,
,,,,
GREEDY,17670,7,1,0,8
,,,,
,,,,
GREEDY,23719,9,1,1,11
,,,,
,,,,
,,,,
GREEDY,27622,7,1,1,9
,,,,
,,,,
,,,,
,,,,
,,,,
,,,,
,,,,
,,,,
,,,,
STATION_GUY,53244,2,0,2,4
,,,,
UTILITY_GUY,25672,3,1,0,4
,,,,
GREEDY,30364,7,0,2,9
GREEDY,47204,8,1,1,10
,,,,
GREEDY,37905,9,0,3,12
,,,,
,,,,
,,,,
,,,,
,,,,
GREEDY,92258,10,0,1,11
DEFAULT,70845,5,0,1,6
DEFAULT,85224,5,1,1,7
,,,,
,,,,
,,,,
,,,,
,,,,
,,,,
,,,,
DEFAULT,65577,11,0,1,12
,,,,
,,,,
,,,,
,,,,
,,,,
,,,,
,,,,
,,,,
,,,,
GREEDY,19836,12,0,1,13
,,,,
GREEDY,15260,6,1,0,7
,,,,
,,,,
,,,,
,,,,
,,,,
STINGY,62838,5,0,1,6
,,,,
GREEDY,20650,9,1,2,12
DEFAULT,50252,4,1,0,5
,,,,
,,,,
,,,,
,,,,
,,,,
,,,,
,,,,
,,,,
GREEDY,23155,8,1,2,11
GREEDY,20968,13,0,1,14
GREEDY,44441,6,1,1,8
,,,,
,,,,
,,,,
DEFAULT,42407,5,0,1,6
GREEDY,19426,8,1,0,9
,,,,
,,,,
GREEDY,17655,7,1,1,9
,,,,
,,,,
,,,,
,,,,
,,,,
GREEDY,19755,11,0,1,12
GREEDY,43922,10,1,1,12
,,,,
GREEDY,22219,11,0,1,12
GREEDY,14468,10,2,2,14
,,,,
GREEDY,16445,7,0,1,8
,,,,
,,,,
,,,,
,,,,
,,,,
,,,,
,,,,
STATION_GUY,44666,5,0,1,6
,,,,
,,,,
GREEDY,17069,7,0,2,9
,,,,
DEFAULT,24969,6,0,0,6
,,,,
UTILITY_GUY,39566,3,0,0,3
,,,,
,,,,
GREEDY,14801,7,1,0,8
,,,,
,,,,
,,,,
DEFAULT,95271,5,1,0,6
,,,,
,,,,
,,,,
GREEDY,16515,9,0,0,9
,,,,
GREEDY,23994,8,1,0,9
,,,,
,,,,
,,,,
,,,,
,,,,
,,,,
,,,,
GREEDY,23243,8,0,1,9
,,,,
DEFAULT,14517,8,0,0,8
,,,,
GREEDY,10907,12,0,1,13
GREEDY,35795,9,0,1,10
,,,,
,,,,
,,,,
UTILITY_GUY,24555,7,1,0,8
,,,,
GREEDY,20415,8,1,1,10
,,,,
,,,,
GREEDY,90345,8,0,1,9
GREEDY,23287,8,0,1,9
,,,,
,,,,
GREEDY,17227,7,1,1,9
,,,,
,,,,
,,,,
,,,,
UTILITY_GUY,27110,5,2,0,7
,,,,
,,,,
UTILITY_GUY,67952,7,0,1,8
GREEDY,16557,7,0,1,8
,,,,
,,,,
,,,,
,,,,
,,,,
,,,,
,,,,
GREEDY,18290,10,0,1,11
UTILITY_GUY,44079,8,2,0,10
,,,,
,,,,
,,,,
UTILITY_GUY,53756,5,1,0,6
DEFAULT,62544,7,0,1,8
,,,,
STATION_GUY,44978,7,0,2,9
GREEDY,19845,9,0,1,10
GREEDY,31172,9,1,1,11
,,,,
,,,,
,,,,
,,,,
STATION_GUY,56452,7,0,3,10
,,,,
GREEDY,13064,12,0,3,15
,,,,
,,,,
,,,,
UTILITY_GUY,31480,4,2,0,6
,,,,
,,,,
,,,,
,,,,
,,,,
,,,,
,,,,
,,,,
GREEDY,67319,9,0,1,10
,,,,
DEFAULT,47748,6,0,2,8
,,,,
,,,,
,,,,
,,,,
,,,,
,,,,
DEFAULT,39353,3,1,1,5
GREEDY,42066,9,1,0,10
UTILITY_GUY,39111,7,1,0,8
UTILITY_GUY,32395,4,0,2,6
GREEDY,61047,12,1,0,13
GREEDY,15833,10,0,0,10
DEFAULT,45506,8,0,0,8
,,,,
,,,,
,,,,
,,,,
,,,,
GREEDY,11594,7,1,2,10
DEFAULT,36298,7,0,1,8
,,,,
,,,,
,,,,
,,,,
GREEDY,19420,8,2,1,11
GREEDY,27930,7,0,2,9
,,,,
,,,,
GREEDY,22947,9,0,1,10
GREEDY,80706,11,1,0,12
,,,,
,,,,
,,,,
,,,,
GREEDY,23637,8,2,2,12
UTILITY_GUY,43579,8,1,0,9
,,,,
,,,,
,,,,
,,,,
,,,,
GREEDY,13298,7,0,2,9
GREEDY,20628,7,2,1,10
STATION_GUY,43712,8,1,0,9
,,,,
GREEDY,65593,7,2,2,11
,,,,
,,,,
,,,,
DEFAULT,24826,4,0,2,6
,,,,
STATION_GUY,22266,4,0,1,5
,,,,
GREEDY,12805,6,0,1,7
,,,,
UTILITY_GUY,35772,5,2,0,7
GREEDY,21893,9,0,0,9
,,,,
,,,,
,,,,
GREEDY,14488,7,1,2,10
,,,,
,,,,
,,,,
,,,,
DEFAULT,28192,8,0,1,9
GREEDY,21489,12,0,1,13
GREEDY,29668,4,0,1,5
,,,,
,,,,
,,,,
STATION_GUY,25859,2,0,4,6
GREEDY,14678,8,0,2,10
GREEDY,48930,10,0,3,13
GREEDY,37483,6,1,2,9
GREEDY,22795,9,1,1,11
DEFAULT,90974,9,0,1,10
GREEDY,24224,8,0,1,9
,,,,
,,,,
,,,,
GREEDY,25251,10,0,2,12
,,,,
GREEDY,19236,8,0,1,9
,,,,
,,,,
,,,,
,,,,
,,,,
,,,,
DEFAULT,78035,5,1,1,7
GREEDY,10592,8,0,1,9
,,,,
,,,,
DEFAULT,32757,7,0,1,8
GREEDY,20633,12,1,2,15
,,,,
,,,,
,,,,
DEFAULT,44690,5,0,1,6
,,,,
,,,,
,,,,
GREEDY,29790,6,1,2,9
,,,,
,,,,
,,,,
,,,,
,,,,
STATION_GUY,25022,3,0,2,5
GREEDY,13778,12,0,1,13
,,,,
,,,,
,,,,
,,,,
,,,,
,,,,
GREEDY,21730,7,2,1,10
STATION_GUY,78871,5,0,1,6
,,,,
,,,,
GREEDY,36970,6,0,3,9
DEFAULT,34271,3,0,0,3
GREEDY,26981,10,0,0,10
DEFAULT,90149,8,0,2,10
,,,,
,,,,
,,,,
DEFAULT,37560,5,0,1,6
,,,,
GREEDY,11005,8,1,1,10
DEFAULT,36409,4,1,1,6
GREEDY,33174,8,0,0,8
,,,,
,,,,
,,,,
GREEDY,17572,7,0,0,7
,,,,
GREEDY,33647,9,1,1,11
,,,,
GREEDY,25784,8,1,0,9
GREEDY,17553,11,0,0,11
UTILITY_GUY,81449,5,0,0,5
,,,,
,,,,
GREEDY,27213,7,1,3,11
,,,,
,,,,
DEFAULT,61846,7,1,1,9
GREEDY,22036,8,0,2,10
,,,,
,,,,
,,,,
,,,,
,,,,
,,,,
,,,,
,,,,
GREEDY,18050,11,1,0,12
STATION_GUY,34315,10,0,1,11
,,,,
,,,,
,,,,
,,,,
,,,,
GREEDY,12580,8,1,1,10
DEFAULT,49108,8,0,0,8
GREEDY,12794,8,1,1,10
,,,,
,,,,
,,,,
,,,,
,,,,
,,,,
,,,,
GREEDY,19092,9,1,1,11
UTILITY_GUY,14871,6,1,1,8
STATION_GUY,64908,5,1,4,10
,,,,
,,,,
GREEDY,25762,10,0,1,11
GREEDY,12065,6,0,1,7
,,,,
,,,,
GREEDY,59117,9,0,2,11
STATION_GUY,39111,5,0,1,6
,,,,
,,,,
GREEDY,34490,8,1,0,9
,,,,
,,,,
,,,,
,,,,
,,,,
STATION_GUY,15039,2,1,4,7
,,,,
,,,,
,,,,
,,,,
,,,,
,,,,
,,,,
,,,,
,,,,
GREEDY,61071,8,2,2,12
GREEDY,11744,9,1,1,11
,,,,
GREEDY,36987,6,0,4,10
,,,,
UTILITY_GUY,56345,5,0,1,6
DEFAULT,43822,7,1,0,8
UTILITY_GUY,46964,8,0,0,8
STATION_GUY,32749,4,0,2,6
,,,,
,,,,
,,,,
GREEDY,22845,4,0,2,6
,,,,
GREEDY,9447,10,1,1,12
,,,,
,,,,
,,,,
,,,,
,,,,
,,,,
,,,,
,,,,
GREEDY,29336,6,1,1,8
GREEDY,24883,10,0,1,11
,,,,
GREEDY,17369,9,0,0,9
,,,,
GREEDY,18088,8,0,1,9
,,,,
,,,,
,,,,
GREEDY,23928,11,0,0,11
,,,,
,,,,
,,,,
,,,,
GREEDY,23974,10,0,1,11
,,,,
DEFAULT,41077,7,0,2,9
,,,,
,,,,
,,,,
GREEDY,22491,13,0,1,14
GREEDY,27803,9,0,1,10
,,,,
,,,,
UTILITY_GUY,52904,7,1,1,9
,,,,
,,,,
,,,,
,,,,
,,,,
,,,,
,,,,
,,,,
,,,,
,,,,
,,,,
,,,,
,,,,
,,,,
,,,,
,,,,
GREEDY,15570,9,0,1,10
DEFAULT,46968,6,0,0,6
,,,,
DEFAULT,35043,6,1,0,7
,,,,
,,,,
,,,,
GREEDY,18930,9,0,3,12
GREEDY,20514,7,0,1,8
,,,,
,,,,
,,,,
,,,,
GREEDY,30858,9,0,1,10
UTILITY_GUY,74507,7,0,0,7
,,,,
,,,,
STATION_GUY,34828,4,1,1,6
DEFAULT,47385,6,1,1,8
,,,,
GREEDY,15195,4,1,0,5
,,,,
,,,,
GREEDY,32336,9,0,1,10
,,,,
,,,,
,,,,
GREEDY,13102,6,1,0,7
,,,,
GREEDY,32751,7,0,2,9
GREEDY,83641,7,1,1,9
,,,,
,,,,
,,,,
,,,,
,,,,
GREEDY,44037,12,1,2,15
,,,,
DEFAULT,78609,4,0,3,7
,,,,
,,,,
GREEDY,14709,6,1,2,9
,,,,
,,,,
,,,,
,,,,
GREEDY,15524,4,0,0,4
GREEDY,12735,9,1,1,11
GREEDY,15342,8,2,1,11
,,,,
DEFAULT,69208,8,0,0,8
,,,,
,,,,
,,,,
GREEDY,19087,8,0,1,9
,,,,
GREEDY,19122,8,0,3,11
,,,,
DEFAULT,34045,7,0,1,8
DEFAULT,93016,4,0,0,4
,,,,
GREEDY,34979,11,1,3,15
,,,,
,,,,
STATION_GUY,72970,3,0,4,7
STATION_GUY,72673,5,0,1,6
,,,,
STATION_GUY,40350,7,1,1,9
,,,,
,,,,
GREEDY,42250,11,1,0,12
,,,,
,,,,
,,,,
GREEDY,21899,11,0,0,11
,,,,
,,,,
,,,,
,,,,
,,,,
GREEDY,20651,8,0,0,8
STATION_GUY,20472,6,0,0,6
GREEDY,37352,10,1,0,11
GREEDY,59128,9,0,1,10
DEFAULT,34160,8,1,0,9
GREEDY,14265,8,0,2,10
GREEDY,29077,10,1,0,11
,,,,
,,,,
,,,,
,,,,
,,,,
DEFAULT,31071,4,1,1,6
STINGY,33986,3,0,0,3
GREEDY,20838,6,2,1,9
,,,,
,,,,
,,,,
,,,,
,,,,
,,,,
,,,,
,,,,
,,,,
,,,,
,,,,
,,,,
STATION_GUY,31043,4,0,2,6
,,,,
,,,,
GREEDY,22217,9,0,0,9
GREEDY,40884,10,0,0,10
,,,,
STATION_GUY,36115,4,1,4,9
,,,,
GREEDY,25287,7,0,0,7
GREEDY,26665,11,0,2,13
,,,,
UTILITY_GUY,49025,4,0,0,4
,,,,
,,,,
,,,,
GREEDY,17956,8,0,1,9
GREEDY,31741,10,0,0,10
,,,,
,,,,
STATION_GUY,33158,6,1,0,7
,,,,
STATION_GUY,40127,3,1,1,5
GREEDY,16517,9,0,1,10
,,,,
GREEDY,36972,9,1,1,11
GREEDY,31879,8,1,1,10
,,,,
,,,,
,,,,
GREEDY,18099,7,1,0,8
DEFAULT,21590,5,0,0,5
,,,,
DEFAULT,45543,5,0,1,6
,,,,
,,,,
,,,,
,,,,
,,,,
,,,,
,,,,
,,,,
GREEDY,15195,7,0,0,7
GREEDY,19998,6,1,0,7
GREEDY,12979,7,0,2,9
,,,,
GREEDY,29973,9,1,1,11
GREEDY,62234,8,1,1,10
,,,,
GREEDY,15106,6,1,4,11
GREEDY,17156,10,0,0,10
,,,,
,,,,
,,,,
GREEDY,11272,8,0,2,10
STATION_GUY,41246,3,0,1,4
,,,,
,,,,
,,,,
UTILITY_GUY,18506,4,1,0,5
,,,,
,,,,
,,,,
,,,,
GREEDY,23403,9,0,0,9
STATION_GUY,54844,6,1,1,8
,,,,
GREEDY,15653,9,0,1,10
,,,,
STATION_GUY,48385,4,0,1,5
,,,,
DEFAULT,29515,5,1,1,7
,,,,
,,,,
,,,,
,,,,
,,,,
GREEDY,19634,6,0,1,7
,,,,
,,,,
,,,,
GREEDY,34716,8,1,2,11
,,,,
,,,,
,,,,
,,,,
,,,,
STATION_GUY,45168,7,0,2,9
,,,,
DEFAULT,64678,5,0,1,6
,,,,
,,,,
,,,,
,,,,
,,,,
,,,,
,,,,
,,,,
GREEDY,28172,9,1,1,11
GREEDY,27279,7,1,0,8
,,,,
,,,,
,,,,
,,,,
,,,,
,,,,
,,,,
,,,,
,,,,
,,,,
GREEDY,31427,10,0,0,10
,,,,
GREEDY,23897,7,0,2,9
DEFAULT,55128,5,0,1,6
,,,,
GREEDY,13431,6,1,1,8
GREEDY,57492,7,1,2,10
,,,,
,,,,
,,,,
DEFAULT,22955,5,1,1,7
,,,,
,,,,
GREEDY,18716,8,1,1,10
,,,,
,,,,
GREEDY,31994,9,1,1,11
GREEDY,29522,8,0,1,9
GREEDY,25362,7,1,2,10
,,,,
,,,,
,,,,
DEFAULT,26766,6,0,0,6
GREEDY,30298,8,0,1,9
,,,,
GREEDY,27680,9,2,0,11
GREEDY,22975,7,1,2,10
,,,,
,,,,
,,,,
STATION_GUY,45964,7,0,2,9
,,,,
STATION_GUY,17607,9,1,4,14
GREEDY,27084,10,1,1,12
,,,,
,,,,
,,,,
,,,,
GREEDY,14178,11,0,1,12
,,,,
,,,,
,,,,
STATION_GUY,32195,7,0,1,8
,,,,
,,,,
GREEDY,37854,6,1,1,8
,,,,
,,,,
,,,,
DEFAULT,20638,6,0,0,6
,,,,
GREEDY,24649,9,0,1,10
,,,,
,,,,
STATION_GUY,53669,7,1,1,9
GREEDY,29328,8,2,3,13
UTILITY_GUY,86151,6,0,1,7
GREEDY,54402,11,1,0,12
GREEDY,37381,7,1,0,8
,,,,
DEFAULT,32500,8,1,0,9
GREEDY,20053,14,2,2,18
,,,,
GREEDY,21285,10,1,1,12
STATION_GUY,44295,5,0,2,7
,,,,
,,,,
,,,,
,,,,
GREEDY,16258,7,2,2,11
,,,,
,,,,
,,,,
GREEDY,20401,8,1,0,9
DEFAULT,67997,6,0,0,6
DEFAULT,39683,8,1,0,9
GREEDY,94728,10,0,0,10
,,,,
,,,,
STATION_GUY,45977,5,0,1,6
GREEDY,57951,9,0,1,10
,,,,
,,,,
DEFAULT,80273,5,0,0,5
STATION_GUY,24174,5,0,3,8
GREEDY,17583,9,0,1,10
,,,,
,,,,
,,,,
,,,,
,,,,
,,,,
UTILITY_GUY,31725,4,0,1,5
,,,,
,,,,
,,,,
,,,,
,,,,
,,,,
DEFAULT,62779,6,1,0,7
,,,,
,,,,
,,,,
,,,,
,,,,
GREEDY,30142,6,0,1,7
,,,,
,,,,
DEFAULT,22600,5,0,2,7
,,,,
,,,,
GREEDY,22821,10,0,2,12
,,,,
GREEDY,52936,8,0,0,8
GREEDY,78296,10,0,1,11
,,,,
,,,,
,,,,
,,,,
,,,,
GREEDY,17632,9,1,0,10
,,,,
,,,,
,,,,
,,,,
,,,,
,,,,
,,,,
GREEDY,22153,8,1,0,9
GREEDY,19429,9,1,2,12
,,,,
STATION_GUY,37788,8,0,2,10
,,,,
,,,,
DEFAULT,20983,8,0,0,8
,,,,
,,,,
,,,,
,,,,
GREEDY,21801,9,0,2,11
GREEDY,37194,9,1,2,12
DEFAULT,25600,6,1,0,7
,,,,
GREEDY,19797,9,0,0,9
,,,,
DEFAULT,74778,6,1,0,7
GREEDY,14677,10,0,1,11
,,,,
,,,,
,,,,
GREEDY,21605,13,0,2,15
,,,,
,,,,
,,,,
,,,,
,,,,
GREEDY,11946,5,1,1,7
,,,,
,,,,
,,,,
,,,,
GREEDY,16527,12,0,1,13
,,,,
,,,,
GREEDY,17544,6,1,0,7
,,,,
,,,,
STATION_GUY,27899,6,0,3,9
,,,,
GREEDY,24864,11,0,1,12
,,,,
,,,,
GREEDY,28965,10,0,1,11
,,,,
GREEDY,25532,8,1,1,10
,,,,
,,,,
,,,,
,,,,
GREEDY,12746,11,0,0,11
,,,,
,,,,
,,,,
,,,,
,,,,
,,,,
,,,,
DEFAULT,38659,9,0,1,10
GREEDY,13665,6,1,1,8
GREEDY,11570,11,0,1,12
GREEDY,12355,11,0,1,12
,,,,
UTILITY_GUY,33059,5,1,0,6
,,,,
,,,,
,,,,
,,,,
,,,,
UTILITY_GUY,73796,8,1,0,9
,,,,
,,,,
,,,,
,,,,
GREEDY,24364,6,0,1,7
,,,,
,,,,
GREEDY,65198,9,2,0,11
,,,,
,,,,
,,,,
,,,,
GREEDY,24674,8,0,1,9
,,,,
GREEDY,31865,9,0,2,11
,,,,
GREEDY,27812,10,1,1,12
,,,,
,,,,
STATION_GUY,38868,5,1,0,6
,,,,
GREEDY,56995,10,0,3,13
STATION_GUY,32909,6,0,2,8
GREEDY,39873,10,0,2,12
GREEDY,26690,10,1,1,12
,,,,
DEFAULT,34460,10,0,0,10
,,,,
,,,,
,,,,
GREEDY,19218,8,1,1,10
,,,,
GREEDY,90382,8,1,1,10
,,,,
,,,,
,,,,
,,,,
GREEDY,52192,10,0,1,11
DEFAULT,22294,8,1,1,10
GREEDY,22395,7,1,2,10
STATION_GUY,38271,4,0,0,4
,,,,
,,,,
,,,,
STINGY,74373,7,0,0,7
GREEDY,31796,6,1,0,7
,,,,
DEFAULT,35095,7,0,1,8
,,,,
GREEDY,16621,9,0,1,10
STATION_GUY,33008,6,0,1,7
STATION_GUY,55920,5,1,4,10
,,,,
,,,,
,,,,
UTILITY_GUY,19784,3,0,1,4
,,,,
,,,,
,,,,
,,,,
GREEDY,30347,11,1,1,13
,,,,
DEFAULT,45241,9,0,0,9
,,,,
,,,,
,,,,
,,,,
,,,,
,,,,
,,,,
GREEDY,15181,8,0,1,9
STATION_GUY,41675,4,0,2,6
,,,,
UTILITY_GUY,59725,6,0,0,6
GREEDY,14893,7,2,1,10
,,,,
,,,,
,,,,
,,,,
GREEDY,18527,8,2,3,13
,,,,
,,,,
UTILITY_GUY,27393,6,0,0,6
,,,,
,,,,
,,,,
GREEDY,28563,4,0,0,4
,,,,
,,,,
,,,,
,,,,
,,,,
,,,,
GREEDY,43251,8,2,1,11
,,,,
GREEDY,30111,10,1,0,11
,,,,
,,,,
,,,,
STATION_GUY,57692,6,1,1,8
,,,,
GREEDY,25112,10,0,2,12
GREEDY,12122,7,0,1,8
GREEDY,28989,10,0,2,12
,,,,
,,,,
,,,,
,,,,
,,,,
GREEDY,16242,5,1,2,8
,,,,
UTILITY_GUY,38707,4,2,0,6
,,,,
STATION_GUY,25105,5,0,0,5
STATION_GUY,14204,5,1,4,10
,,,,
,,,,
,,,,
,,,,
,,,,
GREEDY,30240,6,0,2,8
,,,,
,,,,
GREEDY,33478,7,2,1,10
,,,,
DEFAULT,53344,7,0,1,8
,,,,
GREEDY,18632,10,0,3,13
GREEDY,35538,11,0,0,11
,,,,
GREEDY,37963,11,2,0,13
,,,,
,,,,
,,,,
DEFAULT,52450,3,1,1,5
GREEDY,17467,12,2,0,14
,,,,
,,,,
,,,,
,,,,
,,,,
,,,,
,,,,
GREEDY,19615,10,0,2,12
,,,,
,,,,
,,,,
GREEDY,71102,6,0,2,8
GREEDY,32267,7,0,0,7
,,,,
DEFAULT,53551,8,0,1,9
,,,,
GREEDY,12603,7,0,1,8
,,,,
,,,,
,,,,
GREEDY,8499,4,0,4,8
,,,,
,,,,
,,,,
GREEDY,23146,10,1,0,11
,,,,
,,,,
,,,,
,,,,
,,,,
,,,,
,,,,
DEFAULT,33556,8,0,0,8
,,,,
STATION_GUY,8178,3,0,4,7
UTILITY_GUY,72061,4,0,0,4
,,,,
,,,,
GREEDY,24770,7,0,0,7
,,,,
,,,,
,,,,
GREEDY,23943,7,0,0,7
,,,,
,,,,
,,,,
,,,,
,,,,
,,,,
,,,,
STATION_GUY,32926,5,0,0,5
,,,,
DEFAULT,66910,4,1,0,5
,,,,
GREEDY,24183,7,0,1,8
UTILITY_GUY,31482,4,0,0,4
,,,,
,,,,
,,,,
,,,,
,,,,
,,,,
,,,,
,,,,
,,,,
,,,,
,,,,
DEFAULT,89900,9,1,0,10
,,,,
UTILITY_GUY,76770,6,1,2,9
,,,,
,,,,
STATION_GUY,29589,8,1,1,10
,,,,
STATION_GUY,53758,6,1,3,10
DEFAULT,51205,8,1,1,10
,,,,
,,,,
,,,,
,,,,
,,,,
GREEDY,13330,10,0,3,13
GREEDY,16706,7,0,1,8
,,,,
,,,,
DEFAULT,39464,8,0,1,9
GREEDY,17731,10,0,2,12
,,,,
,,,,
,,,,
GREEDY,27732,8,1,2,11
,,,,
,,,,
,,,,
,,,,
DEFAULT,39965,5,1,1,7
,,,,
STATION_GUY,18794,4,0,2,6
,,,,
UTILITY_GUY,77047,7,0,1,8
,,,,
,,,,
,,,,
,,,,
GREEDY,21073,7,1,1,9
,,,,
,,,,
,,,,
GREEDY,23029,6,2,1,9
GREEDY,24442,10,1,0,11
,,,,
GREEDY,21779,11,0,0,11
DEFAULT,47594,8,0,0,8
GREEDY,18413,8,0,0,8
,,,,
GREEDY,94337,10,1,0,11
,,,,
,,,,
,,,,
GREEDY,28422,8,0,1,9
,,,,
,,,,
,,,,
,,,,
,,,,
GREEDY,16581,5,1,2,8
,,,,
GREEDY,18101,11,1,1,13
,,,,
,,,,
,,,,
GREEDY,20818,6,0,1,7
,,,,
,,,,
GREEDY,23832,8,0,0,8
,,,,
DEFAULT,39381,6,0,1,7
GREEDY,65974,12,0,1,13
,,,,
,,,,
GREEDY,11469,7,1,1,9
,,,,
,,,,
,,,,
