strategy,money,countries,utilities,stations,totalLandsOwned
GREEDY,2454,17,2,3,22
STINGY,1532,1,1,0,2
GREEDY,5162,16,1,2,19
GREEDY,9426,16,2,3,21
GREEDY,8567,11,2,3,16
STINGY,1936,4,0,1,5
GREEDY,2831,15,1,3,19
GREEDY,3881,14,0,4,18
STINGY,1357,2,0,1,3
STINGY,1310,3,0,0,3
GREEDY,2843,19,2,4,25
GREEDY,4185,16,2,3,21
STINGY,1579,1,0,0,1
STINGY,2494,1,0,0,1
STINGY,1692,1,0,1,2
GREEDY,5687,13,2,4,19
GREEDY,10504,14,1,4,19
GREEDY,1106,17,0,3,20
STINGY,2303,3,0,1,4
STINGY,1987,5,0,0,5
GREEDY,8387,15,0,2,17
STINGY,960,4,0,0,4
STINGY,3263,6,0,3,9
GREEDY,1505,19,1,2,22
STINGY,2696,2,0,0,2
STINGY,1396,5,1,2,8
GREEDY,1567,17,1,2,20
GREEDY,1565,13,2,4,19
GREEDY,2630,16,0,2,18
STINGY,1782,5,0,0,5
GREEDY,3899,14,2,4,20
STINGY,1797,2,0,0,2
STINGY,1908,1,1,2,4
STINGY,1410,1,0,0,1
GREEDY,7058,15,1,3,19
GREEDY,12533,14,2,3,19
STINGY,618,8,0,1,9
STINGY,1045,3,0,0,3
STINGY,1551,3,0,0,3
STINGY,1894,1,0,0,1
STINGY,1646,0,0,1,1
GREEDY,3307,12,2,4,18
STINGY,1724,2,1,2,5
GREEDY,3707,14,2,3,19
GREEDY,2689,17,1,3,21
GREEDY,1019,10,0,4,14
GREEDY,3655,14,1,4,19
GREEDY,1155,15,2,3,20
GREEDY,4276,20,2,2,24
GREEDY,2425,18,2,2,22
GREEDY,5343,13,2,3,18
GREEDY,2886,16,2,3,21
GREEDY,1694,15,2,2,19
GREEDY,4402,14,1,3,18
GREEDY,1315,18,2,3,23
STINGY,1422,5,2,0,7
STINGY,1833,1,0,0,1
GREEDY,7040,17,2,4,23
STINGY,1896,3,0,0,3
GREEDY,5516,16,2,4,22
GREEDY,1438,20,2,2,24
STINGY,1009,2,0,1,3
GREEDY,6936,13,2,3,18
GREEDY,1067,16,2,4,22
GREEDY,3966,16,2,2,20
STINGY,1687,2,0,3,5
GREEDY,4001,16,1,1,18
STINGY,2370,0,0,0,0
GREEDY,3746,17,1,2,20
GREEDY,7024,15,2,3,20
STINGY,1242,3,0,0,3
GREEDY,1760,14,0,2,16
STINGY,1424,4,1,0,5
GREEDY,2797,17,1,3,21
GREEDY,9825,14,2,3,19
GREEDY,2660,18,1,3,22
GREEDY,1815,17,2,4,23
STINGY,1770,4,0,1,5
STINGY,1980,1,0,0,1
STINGY,1224,1,0,1,2
STINGY,1350,1,0,1,2
GREEDY,2552,18,1,3,22
GREEDY,9279,15,0,4,19
STINGY,1817,1,1,2,4
STINGY,1542,4,0,2,6
STINGY,1569,3,0,1,4
GREEDY,3725,16,2,4,22
GREEDY,2472,16,2,4,22
STINGY,1481,2,0,1,3
GREEDY,1216,16,0,4,20
GREEDY,3364,17,2,4,23
GREEDY,3563,17,2,4,23
GREEDY,2322,18,2,4,24
GREEDY,3833,18,2,4,24
STINGY,1080,4,0,2,6
STINGY,1395,1,0,0,1
STINGY,1075,5,1,2,8
STINGY,1421,2,0,1,3
STINGY,1559,1,0,0,1
STINGY,2071,5,1,2,8
STINGY,1504,2,0,0,2
STINGY,1370,2,0,0,2
STINGY,2120,1,0,1,2
STINGY,1301,4,0,1,5
GREEDY,1351,12,2,2,16
GREEDY,4175,13,0,4,17
STINGY,1180,5,0,1,6
GREEDY,3361,17,2,4,23
GREEDY,3512,16,2,3,21
STINGY,1258,5,0,0,5
GREEDY,3372,17,1,4,22
GREEDY,2645,16,2,2,20
STINGY,1763,1,1,1,3
GREEDY,4063,17,2,2,21
GREEDY,7426,15,2,2,19
STINGY,1350,0,0,1,1
STINGY,2018,2,0,0,2
STINGY,1333,1,1,0,2
GREEDY,1976,15,2,4,21
GREEDY,4739,16,1,2,19
GREEDY,1600,16,1,2,19
GREEDY,3613,17,2,3,22
GREEDY,807,13,1,3,17
GREEDY,4774,17,0,2,19
GREEDY,4214,17,1,4,22
STINGY,908,5,0,1,6
STINGY,571,3,0,1,4
GREEDY,4849,14,2,3,19
STINGY,1283,7,0,0,7
GREEDY,3350,17,2,4,23
STINGY,1477,4,0,0,4
GREEDY,3711,17,1,3,21
,,,,
STINGY,1490,2,0,0,2
GREEDY,4792,15,1,2,18
GREEDY,1731,18,2,3,23
GREEDY,1590,11,2,4,17
GREEDY,3357,15,1,3,19
STINGY,1156,3,0,0,3
GREEDY,3054,18,1,3,22
STINGY,977,5,0,2,7
GREEDY,3125,19,1,3,23
GREEDY,5026,15,2,3,20
GREEDY,4837,18,0,2,20
GREEDY,3179,17,2,3,22
GREEDY,3462,17,2,3,22
GREEDY,6802,16,2,4,22
GREEDY,4091,17,2,3,22
GREEDY,11854,14,2,3,19
GREEDY,3106,18,2,2,22
GREEDY,5111,16,1,2,19
GREEDY,11753,14,1,3,18
GREEDY,5160,15,1,4,20
GREEDY,7734,11,2,4,17
GREEDY,8816,14,1,2,17
STINGY,1277,2,0,0,2
GREEDY,5463,19,2,3,24
GREEDY,3426,16,2,3,21
STINGY,1418,1,0,0,1
STINGY,1172,2,0,0,2
GREEDY,4284,16,2,3,21
,,,,
GREEDY,2500,15,1,4,20
GREEDY,1240,15,2,2,19
STINGY,872,4,0,0,4
GREEDY,3953,17,1,4,22
GREEDY,1441,18,2,2,22
GREEDY,1742,16,1,3,20
STINGY,1270,2,0,0,2
STINGY,1951,0,0,0,0
GREEDY,4705,16,1,2,19
STINGY,1480,5,1,1,7
GREEDY,3460,16,2,3,21
STINGY,1432,2,0,0,2
STINGY,2261,1,0,1,2
STINGY,1489,2,1,0,3
STINGY,1248,4,1,2,7
GREEDY,6644,15,2,3,20
GREEDY,3042,13,2,2,17
GREEDY,3992,16,2,3,21
GREEDY,6065,14,1,3,18
GREEDY,2291,16,2,3,21
GREEDY,1325,17,2,4,23
GREEDY,7018,14,0,3,17
GREEDY,5038,16,1,2,19
STINGY,1600,1,0,1,2
GREEDY,2546,14,1,4,19
GREEDY,18421,15,1,2,18
GREEDY,5153,17,2,4,23
GREEDY,3986,16,2,2,20
GREEDY,3315,16,1,3,20
STINGY,1198,4,0,0,4
GREEDY,3842,15,2,3,20
GREEDY,3555,21,1,1,23
STINGY,1672,1,0,1,2
GREEDY,9832,13,2,4,19
GREEDY,4205,14,1,3,18
GREEDY,1032,15,2,3,20
STINGY,891,5,0,0,5
GREEDY,2800,18,2,3,23
GREEDY,2993,16,2,2,20
GREEDY,2837,16,2,4,22
STINGY,626,4,0,3,7
GREEDY,2955,18,0,3,21
STINGY,1319,2,0,2,4
GREEDY,4239,15,1,3,19
STINGY,1984,2,0,1,3
STINGY,1243,2,0,0,2
STINGY,1130,2,1,3,6
GREEDY,3433,16,2,3,21
STINGY,1099,4,1,1,6
GREEDY,2960,15,2,4,21
STINGY,1320,1,1,1,3
STINGY,1439,6,2,0,8
GREEDY,2401,15,2,3,20
GREEDY,4827,15,1,2,18
GREEDY,9041,15,2,3,20
STINGY,1679,4,0,0,4
GREEDY,3818,14,1,4,19
GREEDY,3888,17,2,3,22
STINGY,1945,5,0,0,5
STINGY,1036,4,0,0,4
STINGY,1265,0,0,1,1
GREEDY,3590,18,2,3,23
STINGY,1480,3,0,1,4
STINGY,1248,4,1,0,5
STINGY,1925,1,0,1,2
GREEDY,2339,17,2,3,22
STINGY,1071,2,1,1,4
STINGY,1587,2,0,2,4
GREEDY,1341,18,1,3,22
GREEDY,3928,19,2,4,25
STINGY,1529,1,1,1,3
GREEDY,3563,16,1,3,20
STINGY,407,6,0,0,6
GREEDY,1540,13,0,4,17
STINGY,1321,1,1,1,3
STINGY,1051,4,2,1,7
STINGY,1223,2,1,2,5
GREEDY,3007,15,1,3,19
STINGY,571,1,2,0,3
STINGY,1534,3,0,1,4
STINGY,1662,1,1,0,2
GREEDY,5644,15,2,3,20
GREEDY,4168,13,1,3,17
GREEDY,2009,7,1,4,12
GREEDY,3407,18,1,3,22
GREEDY,2740,17,2,3,22
GREEDY,2570,17,2,4,23
STINGY,1002,5,0,0,5
STINGY,1306,4,0,1,5
STINGY,1764,0,0,1,1
STINGY,1351,2,0,0,2
STINGY,1978,1,0,0,1
STINGY,1054,4,0,1,5
STINGY,1634,5,0,0,5
STINGY,1700,6,1,2,9
STINGY,1443,3,0,1,4
GREEDY,6129,16,2,3,21
STINGY,2031,2,0,0,2
GREEDY,3548,18,2,3,23
GREEDY,2911,16,1,3,20
GREEDY,3236,18,2,3,23
STINGY,1515,0,0,0,0
STINGY,1534,2,0,2,4
STINGY,1345,4,1,0,5
STINGY,767,4,0,0,4
GREEDY,1431,19,2,3,24
GREEDY,3583,13,2,3,18
STINGY,1150,3,1,0,4
GREEDY,2325,14,2,3,19
STINGY,967,3,0,0,3
STINGY,1410,4,0,1,5
GREEDY,3805,14,0,3,17
GREEDY,4189,17,2,2,21
GREEDY,4309,19,2,3,24
GREEDY,4358,17,2,3,22
STINGY,743,3,0,0,3
GREEDY,4390,17,1,4,22
GREEDY,4243,16,2,4,22
GREEDY,4539,17,1,3,21
STINGY,1254,3,0,1,4
STINGY,1324,5,0,0,5
STINGY,1269,4,0,0,4
GREEDY,3120,14,2,2,18
GREEDY,7185,14,2,4,20
GREEDY,3843,13,1,4,18
GREEDY,3038,13,1,4,18
STINGY,1273,4,0,0,4
GREEDY,3088,15,2,3,20
GREEDY,3799,13,1,3,17
GREEDY,2671,16,2,3,21
GREEDY,2166,13,1,2,16
GREEDY,2565,16,2,3,21
GREEDY,1189,14,1,4,19
GREEDY,6788,14,0,4,18
GREEDY,5348,16,1,3,20
STINGY,2030,3,1,3,7
GREEDY,2112,15,1,2,18
STINGY,1450,1,0,2,3
GREEDY,3776,11,2,4,17
STINGY,878,6,1,0,7
GREEDY,4321,14,2,3,19
STINGY,1517,2,0,1,3
GREEDY,8437,14,2,1,17
GREEDY,6062,14,2,4,20
GREEDY,2570,14,2,3,19
STINGY,1467,4,1,1,6
GREEDY,6164,18,2,3,23
STINGY,2061,3,0,0,3
GREEDY,1950,15,1,4,20
STINGY,1496,2,0,0,2
GREEDY,4375,17,1,1,19
GREEDY,2447,15,1,3,19
GREEDY,5278,19,2,3,24
STINGY,2005,4,0,1,5
GREEDY,4548,18,1,2,21
STINGY,1580,2,0,0,2
GREEDY,3700,17,2,4,23
GREEDY,1135,16,2,4,22
GREEDY,2987,16,2,3,21
STINGY,1586,3,2,0,5
GREEDY,7294,18,2,3,23
STINGY,1105,1,0,1,2
GREEDY,7473,17,1,2,20
GREEDY,2235,18,0,3,21
STINGY,1677,6,0,0,6
STINGY,1104,3,1,0,4
STINGY,1017,4,0,2,6
GREEDY,4976,17,2,2,21
STINGY,1364,2,0,0,2
STINGY,2094,2,2,1,5
GREEDY,5711,14,1,3,18
STINGY,1197,2,0,1,3
GREEDY,3242,19,2,1,22
GREEDY,7643,15,1,2,18
STINGY,980,4,1,2,7
GREEDY,6594,13,1,3,17
GREEDY,3795,14,1,4,19
GREEDY,1298,11,1,4,16
GREEDY,2744,16,2,4,22
GREEDY,3945,19,2,3,24
GREEDY,2419,13,2,3,18
GREEDY,10289,13,2,3,18
GREEDY,6135,16,1,3,20
STINGY,1995,4,1,0,5
GREEDY,2937,14,2,4,20
STINGY,1747,2,0,1,3
STINGY,741,4,1,1,6
GREEDY,4905,17,2,3,22
GREEDY,5180,17,2,4,23
GREEDY,4917,16,0,2,18
STINGY,1450,0,0,1,1
GREEDY,4556,17,2,2,21
STINGY,1576,2,1,2,5
GREEDY,3964,16,2,3,21
STINGY,1146,4,0,0,4
STINGY,1265,5,0,1,6
GREEDY,4531,18,1,3,22
GREEDY,3741,17,2,2,21
STINGY,767,4,0,1,5
STINGY,1160,6,0,0,6
GREEDY,2784,16,0,2,18
GREEDY,4015,19,2,1,22
STINGY,1491,1,0,2,3
GREEDY,8503,10,2,4,16
STINGY,1136,2,0,0,2
GREEDY,2821,17,2,4,23
GREEDY,2044,16,1,3,20
GREEDY,1679,18,1,4,23
GREEDY,6034,16,2,3,21
STINGY,1104,3,1,1,5
STINGY,984,8,0,1,9
GREEDY,5746,15,1,4,20
STINGY,2243,3,0,3,6
STINGY,1454,1,0,2,3
GREEDY,1650,6,2,4,12
STINGY,1926,1,0,0,1
GREEDY,7998,16,2,2,20
STINGY,440,8,0,1,9
GREEDY,4476,17,1,4,22
STINGY,2021,2,0,3,5
GREEDY,3939,17,2,3,22
STINGY,1160,3,0,0,3
GREEDY,1336,15,2,2,19
STINGY,2142,1,0,1,2
GREEDY,4446,13,2,2,17
GREEDY,2617,14,2,3,19
GREEDY,3552,14,2,4,20
STINGY,2044,1,0,0,1
GREEDY,5105,17,1,3,21
STINGY,564,5,1,0,6
GREEDY,2079,18,2,3,23
GREEDY,3613,16,2,4,22
STINGY,556,4,2,2,8
GREEDY,4017,20,1,2,23
STINGY,2084,5,0,0,5
GREEDY,5443,15,1,3,19
STINGY,2130,0,0,1,1
GREEDY,3241,17,2,3,22
GREEDY,4796,15,2,3,20
STINGY,1422,3,1,0,4
GREEDY,9880,13,0,4,17
GREEDY,6915,13,2,3,18
GREEDY,2200,18,2,2,22
STINGY,1178,4,1,0,5
STINGY,51753,7,0,2,9
GREEDY,3727,16,2,4,22
GREEDY,1291,16,2,2,20
STINGY,1111,4,1,1,6
STINGY,1462,1,0,1,2
STINGY,1270,4,0,0,4
GREEDY,4779,16,1,4,21
GREEDY,4112,17,2,1,20
GREEDY,9326,15,1,3,19
STINGY,1724,3,0,0,3
GREEDY,4418,16,2,3,21
GREEDY,940,16,2,4,22
STINGY,1562,2,1,1,4
GREEDY,2442,17,2,2,21
GREEDY,1691,13,2,2,17
STINGY,1316,2,0,1,3
GREEDY,7201,18,1,4,23
STINGY,1342,2,1,3,6
GREEDY,4881,15,2,4,21
GREEDY,1689,10,2,3,15
GREEDY,8305,13,2,4,19
STINGY,858,6,0,0,6
GREEDY,6470,19,1,1,21
GREEDY,3542,19,2,3,24
STINGY,818,5,1,2,8
STINGY,641,5,0,0,5
GREEDY,3603,15,1,3,19
STINGY,1260,4,0,2,6
STINGY,1982,0,0,0,0
GREEDY,5923,17,1,2,20
GREEDY,3516,16,0,3,19
STINGY,1864,4,0,0,4
STINGY,1439,2,0,1,3
GREEDY,2068,14,1,2,17
GREEDY,2226,14,1,2,17
STINGY,1712,5,0,1,6
GREEDY,7365,12,1,3,16
GREEDY,2995,17,2,3,22
GREEDY,4873,16,2,3,21
GREEDY,2899,16,1,3,20
GREEDY,7445,17,0,4,21
GREEDY,2905,15,2,3,20
GREEDY,2645,14,2,3,19
STINGY,1702,1,0,1,2
GREEDY,849,16,1,4,21
GREEDY,6707,15,2,4,21
GREEDY,4816,16,1,4,21
STINGY,2080,1,1,1,3
STINGY,1831,1,0,1,2
STINGY,1480,1,0,0,1
STINGY,1092,2,0,1,3
GREEDY,1928,17,2,3,22
STINGY,556,8,0,1,9
GREEDY,3916,16,2,3,21
GREEDY,2084,17,1,4,22
GREEDY,2546,15,2,2,19
STINGY,926,3,0,0,3
GREEDY,1363,18,1,1,20
STINGY,1340,0,0,2,2
GREEDY,2851,18,1,2,21
STINGY,1648,3,0,1,4
STINGY,640,2,0,0,2
GREEDY,6006,13,2,2,17
GREEDY,3378,16,2,3,21
STINGY,889,3,0,1,4
GREEDY,8751,16,2,4,22
GREEDY,6085,16,2,3,21
GREEDY,3225,19,1,3,23
GREEDY,5670,17,2,4,23
GREEDY,3284,11,2,4,17
STINGY,778,4,0,2,6
GREEDY,10619,15,1,4,20
STINGY,1195,2,0,1,3
GREEDY,3715,14,2,3,19
STINGY,1746,6,0,0,6
STINGY,2338,2,0,1,3
STINGY,647,5,0,1,6
STINGY,835,3,0,1,4
STINGY,1632,3,0,2,5
STINGY,2262,2,0,1,3
GREEDY,5588,18,0,2,20
GREEDY,3728,13,2,4,19
GREEDY,2742,19,2,3,24
STINGY,1243,3,0,1,4
GREEDY,5712,16,1,3,20
GREEDY,2978,16,2,1,19
STINGY,1624,2,0,3,5
STINGY,1671,4,0,1,5
GREEDY,3031,14,1,1,16
GREEDY,1778,16,2,4,22
GREEDY,4873,17,1,2,20
STINGY,1883,2,0,0,2
GREEDY,3472,18,1,3,22
GREEDY,2240,13,2,4,19
STINGY,1244,2,1,0,3
GREEDY,3349,17,2,2,21
GREEDY,2085,16,0,2,18
GREEDY,3491,16,2,4,22
STINGY,1023,2,0,0,2
GREEDY,7930,16,2,3,21
STINGY,943,5,1,1,7
GREEDY,6677,16,1,3,20
GREEDY,5198,17,2,3,22
GREEDY,2764,19,1,3,23
STINGY,524,4,1,3,8
STINGY,1781,1,0,0,1
GREEDY,3707,19,2,2,23
STINGY,1611,2,0,0,2
STINGY,1345,2,0,0,2
GREEDY,7605,17,2,4,23
GREEDY,3616,19,1,3,23
STINGY,1604,3,0,0,3
GREEDY,17633,15,2,3,20
STINGY,1488,3,0,0,3
GREEDY,8314,16,1,3,20
GREEDY,3383,16,1,3,20
STINGY,1807,2,0,1,3
GREEDY,1733,12,1,0,13
GREEDY,4900,16,1,3,20
GREEDY,2009,15,2,4,21
STINGY,1373,2,0,1,3
GREEDY,3718,16,2,3,21
GREEDY,3650,17,2,4,23
STINGY,1824,0,0,1,1
GREEDY,4607,17,2,3,22
GREEDY,2867,16,1,3,20
GREEDY,3011,14,0,4,18
STINGY,1152,4,2,0,6
STINGY,1855,1,0,0,1
GREEDY,2400,14,1,3,18
GREEDY,2834,14,1,3,18
GREEDY,4899,17,1,3,21
STINGY,1612,3,0,1,4
STINGY,498,4,2,0,6
GREEDY,3492,17,2,2,21
STINGY,1520,1,0,0,1
STINGY,1355,1,0,0,1
GREEDY,8763,13,1,3,17
GREEDY,3127,18,2,2,22
STINGY,1326,2,0,0,2
GREEDY,874,17,2,3,22
GREEDY,3830,17,1,4,22
STINGY,1165,4,1,0,5
STINGY,875,4,1,1,6
GREEDY,3190,16,2,1,19
STINGY,1710,2,0,0,2
STINGY,1990,2,0,2,4
GREEDY,3881,16,2,4,22
STINGY,1713,4,0,0,4
GREEDY,2023,14,0,4,18
GREEDY,3009,19,1,3,23
GREEDY,4737,21,1,4,26
STINGY,1297,2,0,0,2
STINGY,1200,0,0,1,1
GREEDY,6514,15,2,3,20
STINGY,1378,3,0,0,3
STINGY,1634,1,0,1,2
STINGY,1164,3,2,0,5
GREEDY,6520,16,2,3,21
GREEDY,3542,18,2,4,24
STINGY,1493,3,0,2,5
GREEDY,2424,15,2,3,20
GREEDY,1872,18,2,3,23
STINGY,1855,2,1,1,4
GREEDY,3212,15,2,4,21
STINGY,1338,3,1,0,4
STINGY,1130,2,1,0,3
STINGY,1870,0,1,0,1
STINGY,1830,2,0,0,2
STINGY,1544,2,0,1,3
GREEDY,5753,15,1,3,19
GREEDY,5458,15,2,3,20
STINGY,1125,5,0,1,6
GREEDY,2356,19,2,4,25
STINGY,855,5,0,0,5
STINGY,1656,3,0,0,3
STINGY,1272,0,0,2,2
GREEDY,3374,17,1,3,21
GREEDY,2112,15,1,4,20
GREEDY,4348,14,1,4,19
GREEDY,430,17,2,3,22
GREEDY,2706,18,2,3,23
GREEDY,4176,16,2,4,22
GREEDY,3887,16,2,3,21
STINGY,1680,2,0,0,2
STINGY,731,4,0,2,6
GREEDY,4786,17,2,1,20
GREEDY,1111,14,0,3,17
GREEDY,1540,14,1,4,19
GREEDY,3331,16,0,3,19
STINGY,1580,1,0,0,1
GREEDY,4307,18,2,2,22
STINGY,1610,1,0,0,1
GREEDY,3008,16,2,2,20
GREEDY,3560,19,0,4,23
GREEDY,1096,15,2,3,20
GREEDY,15399,17,1,2,20
GREEDY,4197,16,1,3,20
STINGY,1958,3,0,1,4
GREEDY,3876,15,1,3,19
GREEDY,2807,14,2,3,19
GREEDY,3536,14,2,4,20
GREEDY,4454,15,1,2,18
GREEDY,2747,19,2,4,25
GREEDY,7364,15,1,3,19
STINGY,2118,2,0,0,2
GREEDY,5163,16,2,3,21
STINGY,1259,1,1,0,2
GREEDY,3921,20,1,4,25
STINGY,1700,1,0,1,2
GREEDY,9249,18,2,2,22
GREEDY,6222,12,2,4,18
GREEDY,2161,13,1,4,18
STINGY,1950,0,0,0,0
STINGY,1464,4,2,1,7
GREEDY,2920,18,0,3,21
STINGY,1715,3,0,1,4
STINGY,1265,2,1,0,3
GREEDY,82919,15,2,1,18
GREEDY,10425,16,2,2,20
GREEDY,1656,17,1,4,22
GREEDY,1732,15,0,3,18
GREEDY,1890,19,1,4,24
GREEDY,7332,15,1,3,19
STINGY,1092,4,0,0,4
STINGY,1380,3,0,0,3
GREEDY,2460,13,2,4,19
GREEDY,5040,17,2,4,23
GREEDY,1287,15,1,4,20
GREEDY,2174,13,1,4,18
GREEDY,4482,15,2,4,21
STINGY,1463,2,0,0,2
GREEDY,1551,13,1,3,17
STINGY,1128,8,0,0,8
STINGY,2191,2,1,2,5
GREEDY,4458,18,1,2,21
STINGY,1891,2,0,2,4
STINGY,1397,3,0,0,3
GREEDY,3201,16,1,3,20
STINGY,1730,3,0,1,4
GREEDY,4664,14,0,4,18
GREEDY,8563,15,2,3,20
GREEDY,2267,17,1,3,21
GREEDY,7770,15,1,3,19
GREEDY,2242,15,0,2,17
GREEDY,928,12,2,4,18
STINGY,1729,3,0,2,5
GREEDY,3991,17,1,4,22
GREEDY,2839,17,1,3,21
GREEDY,12601,14,2,3,19
GREEDY,37408,13,0,3,16
STINGY,1225,4,1,0,5
GREEDY,4776,14,1,4,19
GREEDY,3337,17,2,3,22
GREEDY,4967,18,2,3,23
GREEDY,2382,16,2,4,22
STINGY,1410,3,1,1,5
STINGY,1346,3,0,1,4
GREEDY,3101,18,2,3,23
GREEDY,2195,19,1,3,23
GREEDY,7173,17,2,2,21
STINGY,1932,3,0,1,4
GREEDY,2447,17,1,2,20
GREEDY,3126,16,1,4,21
STINGY,1970,2,1,0,3
GREEDY,5568,17,1,4,22
STINGY,1264,1,1,0,2
GREEDY,5015,18,1,3,22
GREEDY,2510,13,1,4,18
STINGY,1370,3,0,0,3
GREEDY,4832,18,2,3,23
STINGY,3054,2,0,2,4
STINGY,1770,1,0,1,2
STINGY,1794,2,0,0,2
GREEDY,1555,16,2,4,22
GREEDY,6292,15,1,4,20
GREEDY,1619,15,2,4,21
GREEDY,3269,16,1,3,20
GREEDY,493,9,2,3,14
GREEDY,1687,17,2,3,22
STINGY,1441,2,0,1,3
GREEDY,2779,17,2,4,23
STINGY,1379,3,0,1,4
GREEDY,2728,19,1,3,23
,,,,
STINGY,1420,2,0,0,2
GREEDY,2666,16,2,3,21
STINGY,1892,3,0,3,6
GREEDY,5335,18,2,2,22
GREEDY,4796,15,1,3,19
STINGY,2131,1,1,1,3
GREEDY,10746,13,2,4,19
GREEDY,3754,18,2,2,22
GREEDY,2444,13,1,2,16
STINGY,1591,0,0,2,2
GREEDY,1233,15,0,2,17
STINGY,1233,3,0,3,6
STINGY,2306,2,0,4,6
GREEDY,3616,14,1,4,19
STINGY,1761,4,0,2,6
GREEDY,2637,13,1,4,18
STINGY,2111,1,0,0,1
GREEDY,4068,14,2,2,18
GREEDY,3628,14,2,4,20
STINGY,25086,9,2,1,12
STINGY,1759,6,1,0,7
STINGY,1039,5,0,1,6
GREEDY,4945,15,2,4,21
STINGY,1754,3,1,0,4
STINGY,1671,5,0,1,6
GREEDY,3686,16,1,3,20
STINGY,1904,3,0,0,3
STINGY,908,4,1,0,5
GREEDY,2328,14,2,2,18
GREEDY,1305,13,0,3,16
GREEDY,6361,15,2,3,20
GREEDY,3214,13,1,4,18
GREEDY,3716,16,0,4,20
STINGY,1344,3,0,0,3
STINGY,1862,2,0,1,3
GREEDY,3040,19,2,4,25
GREEDY,1372,19,2,4,25
GREEDY,3134,14,1,4,19
STINGY,1477,5,1,1,7
STINGY,2069,4,0,0,4
STINGY,1483,2,0,0,2
GREEDY,7478,18,2,2,22
STINGY,2015,3,0,0,3
GREEDY,6914,18,2,2,22
STINGY,1380,4,0,1,5
GREEDY,1536,14,0,2,16
GREEDY,5593,18,2,3,23
STINGY,1282,2,1,0,3
GREEDY,6484,17,0,2,19
GREEDY,3760,17,2,4,23
GREEDY,3304,14,2,2,18
GREEDY,8742,17,2,3,22
STINGY,1555,1,0,0,1
STINGY,1949,3,1,0,4
STINGY,1162,3,0,0,3
GREEDY,3437,15,1,2,18
GREEDY,2767,13,0,4,17
GREEDY,5939,14,2,4,20
GREEDY,32915,14,1,2,17
GREEDY,1365,16,1,3,20
STINGY,1845,2,2,1,5
STINGY,1839,1,1,0,2
STINGY,1556,2,0,1,3
STINGY,1560,2,0,0,2
GREEDY,3761,17,2,2,21
GREEDY,1193,17,2,3,22
GREEDY,3339,15,1,3,19
GREEDY,2008,15,2,4,21
GREEDY,5862,16,1,2,19
GREEDY,4345,14,2,3,19
STINGY,1142,3,1,1,5
STINGY,1669,3,0,0,3
GREEDY,2222,15,2,3,20
GREEDY,2560,17,2,3,22
GREEDY,2807,16,2,3,21
STINGY,2032,4,1,1,6
GREEDY,6481,16,0,3,19
STINGY,1640,2,0,0,2
STINGY,1993,2,0,0,2
STINGY,1702,0,0,1,1
STINGY,2028,0,0,0,0
STINGY,1082,5,0,2,7
GREEDY,4859,18,2,3,23
GREEDY,4386,19,1,2,22
GREEDY,4914,16,1,3,20
GREEDY,2964,15,2,3,20
GREEDY,4710,17,2,4,23
GREEDY,4960,15,1,3,19
GREEDY,608,13,2,3,18
STINGY,1070,3,0,1,4
GREEDY,5807,17,1,2,20
STINGY,1082,2,0,1,3
GREEDY,1908,18,2,3,23
GREEDY,1605,16,2,3,21
GREEDY,3766,14,2,3,19
STINGY,1737,2,0,0,2
GREEDY,6492,17,1,2,20
STINGY,1858,2,0,0,2
GREEDY,3834,14,1,4,19
GREEDY,2797,13,1,4,18
GREEDY,7201,17,2,3,22
GREEDY,2051,18,1,4,23
GREEDY,3381,13,2,1,16
STINGY,2307,4,0,1,5
GREEDY,5626,15,1,3,19
GREEDY,3929,17,1,3,21
GREEDY,7090,15,0,2,17
STINGY,1469,1,1,0,2
GREEDY,7505,16,2,3,21
GREEDY,2405,16,2,4,22
GREEDY,1916,18,1,3,22
STINGY,1097,2,0,1,3
GREEDY,2652,16,2,3,21
GREEDY,1190,16,2,4,22
GREEDY,7092,16,1,2,19
STINGY,1553,5,1,1,7
STINGY,1422,2,0,1,3
GREEDY,7579,17,2,3,22
GREEDY,3800,17,2,4,23
STINGY,1170,2,0,1,3
GREEDY,2099,19,2,3,24
GREEDY,5378,16,1,2,19
GREEDY,5574,17,2,3,22
GREEDY,2721,17,2,3,22
GREEDY,2419,19,2,3,24
GREEDY,2310,15,2,3,20
GREEDY,3468,11,2,4,17
STINGY,1108,4,0,2,6
STINGY,2264,1,0,0,1
GREEDY,3731,16,1,4,21
GREEDY,5051,16,1,4,21
STINGY,1916,3,1,1,5
GREEDY,4954,14,1,4,19
STINGY,1638,4,0,1,5
STINGY,1558,5,1,0,6
STINGY,1664,2,0,0,2
STINGY,1403,2,0,0,2
STINGY,1169,4,1,0,5
GREEDY,2487,11,1,3,15
STINGY,1373,1,1,0,2
STINGY,1657,4,0,1,5
GREEDY,5204,12,2,4,18
STINGY,516,5,0,0,5
GREEDY,3634,16,2,2,20
GREEDY,2965,17,2,1,20
STINGY,1804,5,0,0,5
GREEDY,1527,12,2,2,16
GREEDY,3718,15,0,2,17
GREEDY,3061,14,1,3,18
GREEDY,2718,17,2,2,21
GREEDY,3477,14,1,3,18
GREEDY,2286,16,0,4,20
STINGY,1480,1,0,0,1
GREEDY,2825,14,1,3,18
GREEDY,5496,18,1,3,22
GREEDY,2842,14,1,3,18
GREEDY,2187,15,2,3,20
GREEDY,3977,16,1,3,20
GREEDY,3911,17,1,3,21
GREEDY,2721,16,1,4,21
STINGY,1220,2,0,1,3
GREEDY,13391,16,2,4,22
GREEDY,3844,14,2,3,19
STINGY,1580,2,0,0,2
GREEDY,9151,13,1,1,15
GREEDY,5802,15,1,2,18
GREEDY,10848,15,1,3,19
GREEDY,9029,15,2,3,20
GREEDY,6585,16,1,3,20
GREEDY,4584,17,0,2,19
GREEDY,5745,15,2,3,20
GREEDY,4503,15,2,4,21
STINGY,1293,1,0,1,2
GREEDY,2150,19,2,3,24
STINGY,1524,5,0,0,5
STINGY,2796,8,0,0,8
STINGY,1287,3,0,0,3
GREEDY,3485,15,0,3,18
STINGY,1578,2,0,0,2
GREEDY,4947,15,2,3,20
GREEDY,6629,16,2,3,21
GREEDY,3259,15,1,3,19
STINGY,1543,5,1,1,7
GREEDY,42238,14,2,2,18
GREEDY,2765,15,1,3,19
STINGY,2098,1,0,0,1
STINGY,2015,1,0,0,1
STINGY,1938,2,0,0,2
GREEDY,2212,15,2,4,21
GREEDY,2008,16,1,3,20
STINGY,1803,1,0,0,1
STINGY,1466,2,0,1,3
GREEDY,1570,16,1,4,21
STINGY,1494,4,0,0,4
GREEDY,4324,13,2,4,19
STINGY,1444,6,1,0,7
GREEDY,2015,17,1,3,21
STINGY,1837,4,0,1,5
STINGY,1682,0,0,2,2
GREEDY,4062,16,1,3,20
STINGY,1884,3,0,0,3
GREEDY,1458,15,1,2,18
GREEDY,4155,15,2,3,20
GREEDY,5354,17,2,3,22
STINGY,1020,5,0,0,5
STINGY,1439,1,1,0,2
GREEDY,172,11,1,2,14
STINGY,1759,1,0,0,1
GREEDY,3451,16,2,3,21
STINGY,859,5,1,0,6
STINGY,505,6,0,1,7
STINGY,1750,5,0,0,5
GREEDY,2137,16,2,4,22
GREEDY,1094,14,0,2,16
GREEDY,2208,18,2,4,24
GREEDY,2274,13,2,2,17
STINGY,1895,2,0,0,2
STINGY,1791,2,0,1,3
STINGY,1621,3,0,1,4
GREEDY,3222,15,2,3,20
GREEDY,3773,17,1,3,21
GREEDY,8581,16,2,3,21
STINGY,1440,3,0,0,3
GREEDY,4144,13,2,4,19
STINGY,2244,1,0,0,1
STINGY,1158,5,1,1,7
GREEDY,4763,15,2,4,21
STINGY,756,3,0,1,4
STINGY,1854,1,0,2,3
GREEDY,4283,16,2,3,21
GREEDY,4236,15,2,3,20
GREEDY,2665,20,2,4,26
GREEDY,2926,18,2,2,22
STINGY,2132,2,0,0,2
STINGY,1205,2,1,0,3
GREEDY,9711,15,2,3,20
GREEDY,3439,15,1,3,19
GREEDY,18425,14,0,3,17
STINGY,1649,2,0,1,3
GREEDY,2618,16,1,3,20
STINGY,712,6,0,1,7
STINGY,2018,2,0,0,2
STINGY,1735,3,1,0,4
GREEDY,4243,16,2,3,21
STINGY,1264,6,0,0,6
GREEDY,2513,16,2,3,21
GREEDY,3399,14,2,4,20
GREEDY,3783,17,2,2,21
STINGY,1300,3,0,1,4
GREEDY,3672,13,0,4,17
STINGY,1396,5,1,0,6
GREEDY,5215,17,2,2,21
STINGY,1266,7,0,0,7
GREEDY,4413,15,1,3,19
GREEDY,1363,14,2,3,19
GREEDY,2463,15,2,4,21
GREEDY,2575,15,1,4,20
GREEDY,2271,14,1,2,17
STINGY,1174,3,0,0,3
STINGY,1740,1,1,1,3
GREEDY,2714,18,2,4,24
GREEDY,3234,19,2,2,23
GREEDY,1759,16,2,3,21
GREEDY,787,17,1,4,22
STINGY,1377,2,0,0,2
GREEDY,10519,17,1,2,20
GREEDY,8015,15,2,2,19
GREEDY,4272,16,2,3,21
GREEDY,2126,15,2,4,21
STINGY,1351,1,0,0,1
GREEDY,8119,12,2,3,17
GREEDY,4461,17,2,4,23
STINGY,1083,5,0,0,5
GREEDY,1592,14,2,3,19
STINGY,1334,4,0,0,4
STINGY,954,1,1,1,3
GREEDY,2608,18,1,4,23
STINGY,1056,4,1,1,6
STINGY,2479,1,0,1,2
GREEDY,4848,18,1,2,21
GREEDY,4636,17,1,2,20
STINGY,1871,2,0,0,2
GREEDY,1971,16,0,3,19
STINGY,1472,1,0,0,1
GREEDY,4759,18,1,2,21
GREEDY,681,13,1,2,16
GREEDY,1379,13,1,3,17
GREEDY,1495,18,2,4,24
STINGY,1246,1,0,1,2
GREEDY,3929,16,2,3,21
GREEDY,4738,16,1,3,20
GREEDY,1340,16,1,3,20
STINGY,1690,1,0,0,1
STINGY,1288,0,1,1,2
GREEDY,2129,13,2,4,19
STINGY,1438,1,1,0,2
STINGY,1814,3,0,1,4
GREEDY,4187,18,2,3,23
GREEDY,4550,17,2,3,22
GREEDY,2938,15,2,3,20
GREEDY,4387,18,1,2,21
STINGY,1498,3,0,0,3
STINGY,768,4,0,0,4
GREEDY,2002,14,2,4,20
GREEDY,3462,17,1,2,20
GREEDY,2740,19,0,3,22
GREEDY,6887,15,2,2,19
GREEDY,998,8,1,4,13
GREEDY,3985,17,2,3,22
STINGY,1416,5,0,0,5
GREEDY,1036,14,2,3,19
STINGY,1036,7,0,1,8
GREEDY,3259,16,1,3,20
GREEDY,1756,15,0,3,18
GREEDY,5723,17,2,2,21
STINGY,1370,2,0,3,5
STINGY,1442,2,0,3,5
GREEDY,9834,16,1,3,20
STINGY,1823,1,0,0,1
STINGY,1625,1,0,1,2
GREEDY,3653,15,2,4,21
STINGY,1512,2,0,0,2
STINGY,881,4,1,0,5
GREEDY,1883,18,0,3,21
STINGY,2351,5,2,0,7
GREEDY,2666,14,2,4,20
STINGY,1006,4,1,2,7
GREEDY,1207,14,1,4,19
STINGY,1332,2,1,0,3
STINGY,914,7,0,0,7
GREEDY,2963,17,1,2,20
STINGY,2808,2,0,0,2
GREEDY,4535,18,2,4,24
GREEDY,5210,16,2,4,22
GREEDY,3756,16,1,4,21
STINGY,1228,2,0,1,3
GREEDY,2201,15,2,3,20
STINGY,1128,4,1,1,6
GREEDY,1487,13,2,3,18
STINGY,814,6,0,1,7
STINGY,2054,1,0,0,1
STINGY,2658,3,0,1,4
GREEDY,5539,17,2,3,22
GREEDY,4476,15,2,3,20
STINGY,1999,5,1,1,7
GREEDY,5236,16,1,3,20
GREEDY,6452,17,1,3,21
GREEDY,2750,16,2,2,20
GREEDY,1625,17,1,4,22
GREEDY,9693,16,2,3,21
GREEDY,4135,15,1,3,19
STINGY,1530,1,0,1,2
GREEDY,2961,18,2,3,23
GREEDY,5369,18,1,3,22
GREEDY,3136,16,2,3,21
STINGY,1700,0,1,0,1
GREEDY,4623,17,2,3,22
GREEDY,2420,16,0,3,19
STINGY,1300,3,0,0,3
GREEDY,3696,18,2,4,24
STINGY,1559,1,0,0,1
GREEDY,3325,18,1,4,23
STINGY,1782,2,0,1,3
GREEDY,1672,16,2,4,22
STINGY,792,3,0,1,4
GREEDY,2643,16,0,2,18
STINGY,778,5,1,1,7
GREEDY,6713,18,0,3,21
STINGY,1087,2,0,1,3
STINGY,1928,5,0,0,5
GREEDY,3607,17,0,2,19
STINGY,1344,3,0,0,3
STINGY,2216,2,1,1,4
STINGY,706,5,0,0,5
GREEDY,4116,14,2,3,19
GREEDY,3343,16,1,3,20
GREEDY,1964,14,2,3,19
GREEDY,4431,15,1,2,18
GREEDY,3768,14,1,2,17
GREEDY,9942,12,1,3,16
GREEDY,3798,16,2,3,21
GREEDY,1115,11,1,4,16
GREEDY,5125,15,2,3,20
STINGY,1764,2,0,2,4
GREEDY,2200,15,2,4,21
GREEDY,3249,16,2,3,21
GREEDY,3733,18,2,2,22
GREEDY,2828,19,2,3,24
STINGY,1077,3,0,0,3
GREEDY,1553,16,2,4,22
GREEDY,2393,16,2,2,20
,,,,
STINGY,1230,3,0,1,4
GREEDY,5050,16,2,3,21
GREEDY,1249,16,1,3,20
STINGY,2319,2,1,0,3
STINGY,1920,1,0,0,1
STINGY,1330,4,1,0,5
STINGY,1859,4,1,0,5
STINGY,1302,3,1,0,4
GREEDY,2721,17,2,3,22
STINGY,1429,3,0,0,3
STINGY,1959,1,0,0,1
GREEDY,2358,15,1,3,19
GREEDY,4056,15,1,4,20
GREEDY,2714,17,1,2,20
STINGY,723,5,1,1,7
STINGY,1419,4,0,1,5
STINGY,1513,4,0,0,4
STINGY,1259,5,0,2,7
GREEDY,571,18,2,4,24
GREEDY,2898,13,1,4,18
GREEDY,3246,18,2,3,23
STINGY,1386,3,0,2,5
GREEDY,1782,14,1,4,19
STINGY,1461,2,0,0,2
GREEDY,5263,16,2,3,21
STINGY,1342,3,1,0,4
GREEDY,1373,17,2,4,23
GREEDY,5466,19,2,3,24
GREEDY,2795,14,2,1,17
STINGY,1348,0,0,1,1
GREEDY,149,10,1,2,13
STINGY,1429,6,0,1,7
GREEDY,2172,19,2,3,24
GREEDY,4105,14,2,4,20
GREEDY,3406,11,2,3,16
GREEDY,6699,15,2,2,19
GREEDY,2649,15,1,3,19
GREEDY,5026,19,2,3,24
GREEDY,5465,18,2,3,23
STINGY,1716,3,0,1,4
STINGY,1614,1,0,0,1
STINGY,1079,4,0,2,6
GREEDY,6024,17,2,2,21
STINGY,1703,2,0,0,2
STINGY,1864,2,0,2,4
STINGY,1930,3,0,0,3
GREEDY,4898,15,1,4,20
GREEDY,2623,17,1,4,22
GREEDY,5709,14,2,4,20
STINGY,264,3,0,1,4
GREEDY,2511,16,2,4,22
STINGY,1733,3,0,1,4
GREEDY,1100,16,1,4,21
GREEDY,1364,14,1,2,17
STINGY,1415,5,0,1,6
STINGY,1941,4,0,0,4
STINGY,2066,1,0,1,2
STINGY,592,3,0,0,3
GREEDY,4402,17,1,4,22
GREEDY,2394,15,2,3,20
STINGY,900,6,0,1,7
STINGY,1897,1,0,0,1
STINGY,1110,5,1,0,6
GREEDY,3136,18,0,4,22
GREEDY,6796,16,2,3,21
GREEDY,2927,19,1,3,23
STINGY,1230,5,0,0,5
GREEDY,2383,18,2,3,23
GREEDY,2353,13,2,3,18
STINGY,1274,7,0,0,7
STINGY,1686,2,0,0,2
STINGY,1174,3,0,1,4
STINGY,946,5,0,1,6
STINGY,1634,2,0,0,2
GREEDY,2338,18,1,2,21
STINGY,1763,4,1,0,5
STINGY,1850,0,0,0,0
STINGY,1262,2,0,0,2
GREEDY,2275,14,2,3,19
GREEDY,2301,10,1,4,15
GREEDY,1355,18,1,3,22
STINGY,1813,4,0,3,7
GREEDY,1451,14,1,3,18
STINGY,1292,3,0,0,3
GREEDY,2793,17,1,3,21
STINGY,1342,2,0,0,2
STINGY,1704,5,0,3,8
STINGY,1242,2,1,0,3
STINGY,1144,2,0,1,3
GREEDY,2935,15,2,2,19
GREEDY,2563,17,1,2,20
GREEDY,2965,15,1,3,19
STINGY,1273,0,0,1,1
GREEDY,2880,16,2,3,21
GREEDY,2937,16,2,3,21
GREEDY,3171,16,2,2,20
GREEDY,8399,14,0,3,17
GREEDY,2478,18,1,3,22
GREEDY,1715,13,1,3,17
GREEDY,2416,13,1,3,17
GREEDY,4198,12,2,3,17
GREEDY,2059,11,2,4,17
GREEDY,3802,15,2,3,20
GREEDY,1859,17,2,2,21
STINGY,1342,0,0,2,2
STINGY,950,2,0,1,3
GREEDY,5617,11,1,4,16
GREEDY,2136,16,1,3,20
GREEDY,1737,13,2,4,19
GREEDY,1313,13,2,4,19
GREEDY,3149,18,2,3,23
GREEDY,3810,15,2,3,20
STINGY,1540,1,0,0,1
GREEDY,4623,15,2,4,21
STINGY,1576,2,1,1,4
GREEDY,1789,17,2,4,23
GREEDY,1867,16,1,4,21
GREEDY,2911,17,2,3,22
STINGY,1258,5,0,2,7
GREEDY,3082,17,1,4,22
GREEDY,4716,13,2,3,18
STINGY,1430,2,0,0,2
GREEDY,8260,16,0,2,18
GREEDY,661,13,2,2,17
GREEDY,2815,17,2,3,22
STINGY,2314,3,0,0,3
GREEDY,2048,19,2,2,23
GREEDY,6066,17,1,3,21
GREEDY,2252,14,2,4,20
GREEDY,2723,17,2,3,22
STINGY,1801,3,0,1,4
GREEDY,746,12,1,3,16
GREEDY,1607,18,1,2,21
GREEDY,2719,15,2,2,19
STINGY,714,4,0,2,6
GREEDY,2323,16,2,3,21
GREEDY,3065,15,2,3,20
GREEDY,2026,18,1,4,23
GREEDY,1873,16,0,2,18
STINGY,1068,6,2,1,9
STINGY,1160,3,0,0,3
GREEDY,3313,14,1,2,17
GREEDY,5787,16,2,3,21
STINGY,1832,1,0,0,1
STINGY,1554,0,0,1,1
STINGY,1071,4,0,1,5
GREEDY,1588,9,1,2,12
GREEDY,1918,15,2,3,20
GREEDY,1591,16,2,4,22
GREEDY,5931,14,1,3,18
STINGY,1402,3,0,3,6
STINGY,1213,3,1,1,5
GREEDY,4811,14,2,4,20
GREEDY,3821,16,2,3,21
GREEDY,3059,17,1,2,20
STINGY,1604,2,0,1,3
STINGY,1046,3,1,1,5
STINGY,1843,1,0,0,1
GREEDY,2014,16,2,3,21
STINGY,1780,1,0,0,1
STINGY,1507,1,0,1,2
STINGY,1724,2,0,1,3
STINGY,1659,1,1,0,2
GREEDY,5419,15,2,3,20
STINGY,2047,5,1,1,7
STINGY,1594,8,1,2,11
STINGY,924,3,1,1,5
GREEDY,2921,19,2,3,24
GREEDY,2841,19,2,4,25
STINGY,1467,1,0,0,1
STINGY,1584,2,1,1,4
STINGY,1366,3,0,0,3
STINGY,1456,3,0,1,4
GREEDY,7141,17,2,2,21
STINGY,1258,5,0,0,5
GREEDY,2566,14,1,4,19
,,,,
STINGY,1049,2,1,1,4
GREEDY,2715,15,2,3,20
GREEDY,2129,19,1,3,23
STINGY,2211,3,0,2,5
GREEDY,4854,17,1,2,20
GREEDY,4527,17,1,2,20
GREEDY,940,13,2,2,17
GREEDY,3107,18,2,3,23
STINGY,1500,3,1,2,6
GREEDY,2915,18,1,3,22
GREEDY,12518,17,2,1,20
GREEDY,13058,13,2,3,18
GREEDY,3573,16,2,3,21
GREEDY,1669,17,2,3,22
GREEDY,6116,17,2,1,20
STINGY,1926,1,0,1,2
GREEDY,741,11,0,4,15
GREEDY,539,13,0,4,17
STINGY,2253,4,0,0,4
STINGY,1559,5,0,1,6
GREEDY,5102,14,0,4,18
STINGY,1382,5,0,1,6
STINGY,1733,1,0,0,1
GREEDY,3964,16,2,2,20
GREEDY,1670,10,1,4,15
GREEDY,1380,13,2,4,19
STINGY,2717,4,0,2,6
GREEDY,3572,16,1,2,19
STINGY,1718,5,1,1,7
STINGY,1178,1,0,1,2
STINGY,1594,1,1,1,3
STINGY,1224,2,0,0,2
GREEDY,5335,15,2,4,21
STINGY,1002,3,0,2,5
STINGY,1383,4,0,1,5
STINGY,1534,1,1,0,2
STINGY,1944,0,0,1,1
STINGY,1428,1,0,0,1
GREEDY,4079,19,0,3,22
GREEDY,6855,17,2,3,22
GREEDY,4659,17,2,2,21
GREEDY,6348,16,2,3,21
GREEDY,5260,15,2,4,21
GREEDY,1490,18,2,2,22
STINGY,2034,1,0,1,2
GREEDY,1534,16,2,3,21
GREEDY,1512,17,2,3,22
STINGY,948,5,1,0,6
GREEDY,2186,15,1,3,19
STINGY,1012,3,0,0,3
STINGY,924,2,0,1,3
STINGY,799,5,0,0,5
GREEDY,6737,15,1,2,18
STINGY,1728,0,0,1,1
GREEDY,3823,17,2,4,23
GREEDY,5067,16,2,4,22
GREEDY,2043,17,0,4,21
GREEDY,1318,15,1,4,20
GREEDY,3637,16,1,3,20
GREEDY,1414,14,0,3,17
STINGY,1962,2,1,0,3
GREEDY,1340,14,2,3,19
STINGY,1684,2,0,1,3
STINGY,1327,5,0,0,5
STINGY,1953,1,0,0,1
GREEDY,1784,11,2,3,16
GREEDY,1656,11,1,4,16
GREEDY,3370,18,1,4,23
GREEDY,1883,17,2,4,23
GREEDY,2732,14,2,2,18
STINGY,1849,3,0,2,5
STINGY,2180,7,0,1,8
GREEDY,3990,17,2,3,22
STINGY,1742,0,0,0,0
STINGY,1204,1,0,1,2
STINGY,1860,6,1,2,9
GREEDY,10350,15,1,3,19
STINGY,1425,1,0,1,2
GREEDY,2742,13,0,3,16
GREEDY,5084,16,2,2,20
GREEDY,6700,15,1,3,19
STINGY,2169,0,0,0,0
STINGY,1351,2,0,1,3
GREEDY,2580,17,2,3,22
GREEDY,7005,17,1,2,20
GREEDY,840,14,1,3,18
STINGY,1328,4,2,1,7
STINGY,2044,0,0,0,0
STINGY,1864,4,0,1,5
GREEDY,6798,15,1,3,19
GREEDY,4761,15,2,3,20
STINGY,1656,3,0,1,4
GREEDY,1405,14,2,3,19
GREEDY,121,17,1,3,21
GREEDY,11998,17,1,1,19
STINGY,2226,2,1,1,4
GREEDY,2989,13,2,4,19
GREEDY,6114,16,2,3,21
STINGY,1800,5,0,0,5
STINGY,1600,5,1,0,6
STINGY,1654,5,1,0,6
GREEDY,4243,17,2,4,23
GREEDY,2410,18,1,4,23
STINGY,841,5,0,0,5
GREEDY,5167,17,1,3,21
GREEDY,3351,15,2,4,21
GREEDY,2564,18,2,4,24
STINGY,1028,3,0,0,3
GREEDY,2332,19,1,3,23
GREEDY,4037,17,2,4,23
GREEDY,9082,15,0,2,17
STINGY,1444,5,2,0,7
STINGY,851,3,0,0,3
GREEDY,3294,17,2,2,21
STINGY,2271,2,0,2,4
STINGY,1375,5,1,0,6
GREEDY,2846,14,1,3,18
STINGY,1121,5,0,1,6
STINGY,1241,1,0,2,3
STINGY,1491,4,0,0,4
GREEDY,3193,13,1,3,17
STINGY,1150,1,0,1,2
GREEDY,5106,17,1,2,20
GREEDY,2739,17,1,3,21
GREEDY,5250,15,2,3,20
GREEDY,3065,18,2,3,23
GREEDY,2986,17,1,3,21
GREEDY,4071,14,2,2,18
GREEDY,2625,14,2,4,20
STINGY,1798,1,0,0,1
GREEDY,4836,13,1,3,17
GREEDY,5581,16,1,3,20
STINGY,2052,6,0,0,6
GREEDY,8247,16,1,4,21
GREEDY,1883,15,1,2,18
STINGY,1571,5,0,0,5
STINGY,1985,1,2,2,5
GREEDY,1309,15,0,4,19
GREEDY,2894,15,2,3,20
STINGY,1606,0,0,0,0
STINGY,727,4,0,0,4
GREEDY,10691,15,2,2,19
GREEDY,4099,18,1,4,23
STINGY,704,3,1,2,6
GREEDY,3037,18,2,3,23
GREEDY,5344,15,1,3,19
STINGY,970,5,1,2,8
GREEDY,2151,18,1,2,21
STINGY,1122,4,0,0,4
STINGY,1178,3,0,0,3
STINGY,830,4,2,0,6
GREEDY,4723,13,1,1,15
STINGY,1774,1,0,0,1
STINGY,1474,1,0,0,1
GREEDY,1499,16,2,1,19
GREEDY,4401,16,2,2,20
GREEDY,6168,17,1,3,21
GREEDY,2193,14,1,4,19
STINGY,1486,6,2,0,8
STINGY,1986,0,0,0,0
GREEDY,4251,14,1,4,19
STINGY,1755,3,0,2,5
STINGY,1222,2,0,0,2
STINGY,1430,5,0,0,5
STINGY,1922,4,1,1,6
GREEDY,4577,15,1,3,19
STINGY,1226,4,0,0,4
GREEDY,2415,16,2,4,22
GREEDY,1881,15,2,2,19
STINGY,1313,6,1,0,7
STINGY,1757,0,0,2,2
GREEDY,2849,17,2,3,22
STINGY,885,1,0,1,2
GREEDY,549,10,1,3,14
GREEDY,3535,14,1,3,18
GREEDY,1059,12,1,3,16
GREEDY,2682,19,2,2,23
GREEDY,5785,18,2,3,23
GREEDY,2215,16,2,4,22
STINGY,523,5,0,1,6
GREEDY,4847,15,1,3,19
GREEDY,6269,18,2,3,23
STINGY,1759,2,0,0,2
STINGY,1645,1,1,1,3
STINGY,1071,2,0,3,5
STINGY,1390,2,0,0,2
GREEDY,1922,20,2,3,25
GREEDY,5438,17,0,4,21
STINGY,1457,6,0,3,9
STINGY,1892,4,0,1,5
GREEDY,4841,16,2,2,20
GREEDY,1547,15,2,1,18
GREEDY,2340,15,1,4,20
GREEDY,4711,19,1,2,22
GREEDY,5940,15,2,2,19
GREEDY,3999,17,1,2,20
GREEDY,2054,15,1,3,19
GREEDY,3748,17,2,4,23
STINGY,366,6,1,1,8
GREEDY,2571,17,2,3,22
GREEDY,1105,13,1,4,18
STINGY,1271,1,1,1,3
STINGY,894,6,0,0,6
STINGY,1431,6,0,0,6
GREEDY,9797,15,2,3,20
GREEDY,2721,16,2,4,22
STINGY,1650,1,0,0,1
STINGY,747,4,0,1,5
STINGY,1674,1,0,0,1
STINGY,1616,1,0,0,1
STINGY,986,2,1,0,3
GREEDY,3495,15,0,3,18
GREEDY,1394,15,2,2,19
STINGY,1387,2,0,0,2
STINGY,1574,3,0,0,3
GREEDY,1018,20,0,2,22
STINGY,2119,2,0,0,2
GREEDY,3996,18,2,3,23
STINGY,862,4,0,1,5
STINGY,1318,5,0,0,5
STINGY,856,3,0,2,5
GREEDY,3573,17,2,3,22
GREEDY,3962,17,1,3,21
STINGY,1653,5,0,0,5
STINGY,1872,1,0,2,3
GREEDY,2293,18,2,3,23
STINGY,1605,1,0,0,1
GREEDY,5516,15,2,3,20
STINGY,1222,4,0,2,6
STINGY,1328,3,1,0,4
GREEDY,4265,13,2,4,19
STINGY,1328,2,0,0,2
GREEDY,1969,17,2,3,22
GREEDY,3011,15,1,3,19
GREEDY,13486,15,1,3,19
GREEDY,3842,18,1,3,22
GREEDY,3914,15,2,4,21
GREEDY,3114,18,2,2,22
STINGY,946,2,0,3,5
STINGY,1385,4,0,2,6
STINGY,1502,3,0,0,3
STINGY,1936,2,0,0,2
STINGY,1786,1,0,0,1
STINGY,646,5,0,1,6
GREEDY,4619,15,2,1,18
STINGY,1649,3,0,0,3
GREEDY,4834,17,2,3,22
GREEDY,4590,20,2,2,24
STINGY,1580,3,0,0,3
STINGY,1902,1,0,0,1
GREEDY,3044,14,2,2,18
GREEDY,3746,14,2,3,19
GREEDY,2326,12,2,3,17
STINGY,2288,6,0,0,6
GREEDY,2218,13,1,3,17
GREEDY,3006,16,2,3,21
GREEDY,1685,16,2,2,20
GREEDY,5658,16,2,3,21
STINGY,993,4,1,1,6
GREEDY,5235,16,2,1,19
GREEDY,5403,16,1,3,20
,,,,
GREEDY,3856,14,1,3,18
GREEDY,4905,12,2,3,17
GREEDY,2435,15,2,4,21
STINGY,2201,0,0,0,0
GREEDY,4642,16,1,3,20
STINGY,1044,3,0,0,3
GREEDY,3691,12,1,3,16
GREEDY,4800,16,0,3,19
STINGY,1526,2,0,0,2
GREEDY,2034,13,1,2,16
STINGY,852,4,0,0,4
STINGY,584,4,0,1,5
GREEDY,1564,16,2,4,22
GREEDY,3310,19,2,3,24
GREEDY,1792,13,2,2,17
STINGY,1055,6,0,0,6
GREEDY,3384,20,2,4,26
GREEDY,1310,14,1,3,18
GREEDY,3191,18,2,2,22
GREEDY,3617,15,2,4,21
GREEDY,2156,17,2,3,22
GREEDY,5539,12,2,2,16
GREEDY,3614,15,1,4,20
STINGY,950,5,0,1,6
GREEDY,6387,14,2,3,19
GREEDY,4178,13,1,4,18
STINGY,1375,2,0,0,2
STINGY,1101,5,0,0,5
STINGY,1310,4,0,2,6
STINGY,1524,3,0,1,4
STINGY,1748,5,1,1,7
GREEDY,3657,15,2,2,19
STINGY,2456,4,1,1,6
GREEDY,2495,17,2,2,21
GREEDY,4072,16,2,3,21
GREEDY,2906,11,2,4,17
GREEDY,2414,17,1,4,22
GREEDY,7842,15,2,3,20
GREEDY,2177,19,2,3,24
GREEDY,2640,12,2,4,18
STINGY,689,4,0,1,5
STINGY,1760,1,0,0,1
GREEDY,3809,18,1,4,23
STINGY,929,5,0,1,6
GREEDY,5130,18,1,4,23
GREEDY,1015,18,2,3,23
STINGY,1448,3,0,0,3
STINGY,2418,1,0,1,2
GREEDY,3898,15,1,4,20
GREEDY,3807,17,1,3,21
GREEDY,12282,12,2,3,17
GREEDY,5807,11,1,4,16
GREEDY,3380,14,1,3,18
GREEDY,2361,13,1,4,18
GREEDY,1486,13,2,4,19
GREEDY,3112,18,2,4,24
GREEDY,8281,15,1,4,20
GREEDY,7984,14,2,3,19
GREEDY,5334,18,2,2,22
GREEDY,3367,17,2,4,23
GREEDY,2026,15,2,3,20
GREEDY,1795,12,2,4,18
STINGY,1392,2,0,0,2
GREEDY,2765,18,1,2,21
GREEDY,4230,15,1,1,17
GREEDY,10891,16,2,2,20
GREEDY,7640,16,2,1,19
STINGY,1075,3,1,0,4
GREEDY,2051,19,2,3,24
GREEDY,3972,14,2,2,18
GREEDY,4190,19,2,3,24
GREEDY,5672,17,2,3,22
STINGY,1487,3,0,0,3
GREEDY,2729,18,1,4,23
STINGY,2105,3,2,2,7
STINGY,1565,2,0,0,2
STINGY,1322,7,0,3,10
GREEDY,5198,15,2,3,20
GREEDY,3183,16,1,2,19
GREEDY,3527,18,2,3,23
GREEDY,2562,18,2,3,23
STINGY,988,1,2,0,3
STINGY,1167,4,0,1,5
GREEDY,1483,18,1,3,22
STINGY,1560,2,0,0,2
GREEDY,6195,16,2,3,21
STINGY,1472,4,0,1,5
STINGY,1115,3,1,1,5
GREEDY,4735,16,1,3,20
STINGY,1026,1,0,2,3
GREEDY,2431,17,2,4,23
GREEDY,2519,18,2,3,23
STINGY,774,4,0,0,4
GREEDY,6340,17,2,2,21
STINGY,1189,4,0,1,5
GREEDY,4979,18,2,4,24
STINGY,1736,3,1,1,5
STINGY,1329,4,0,1,5
GREEDY,7884,17,1,1,19
STINGY,792,2,2,1,5
GREEDY,6505,16,2,2,20
,,,,
GREEDY,8700,18,1,1,20
STINGY,1076,2,0,1,3
STINGY,1638,10,0,1,11
GREEDY,3583,17,1,2,20
GREEDY,3916,15,1,3,19
STINGY,2037,4,1,2,7
STINGY,1116,3,0,0,3
GREEDY,3859,16,1,3,20
STINGY,1918,0,0,0,0
GREEDY,2156,17,2,4,23
GREEDY,3276,15,0,4,19
GREEDY,4018,13,1,3,17
GREEDY,5178,17,1,2,20
GREEDY,4460,16,1,2,19
GREEDY,3706,15,1,4,20
STINGY,1410,2,0,0,2
GREEDY,2863,16,2,3,21
GREEDY,6320,14,1,2,17
GREEDY,5717,17,0,4,21
STINGY,1494,4,0,0,4
STINGY,1859,0,0,0,0
GREEDY,3101,14,2,3,19
GREEDY,3077,16,1,3,20
GREEDY,3391,17,1,2,20
GREEDY,7351,15,1,4,20
GREEDY,1707,10,2,3,15
STINGY,2210,1,0,0,1
GREEDY,4954,17,1,3,21
GREEDY,4608,14,2,3,19
GREEDY,2220,16,2,3,21
GREEDY,2843,12,2,4,18
GREEDY,1305,12,1,4,17
STINGY,1230,2,0,1,3
GREEDY,1615,15,1,2,18
GREEDY,5726,15,2,3,20
STINGY,1661,3,1,2,6
GREEDY,2700,19,2,3,24
STINGY,1366,2,0,2,4
STINGY,2020,1,0,3,4
GREEDY,6584,14,1,3,18
STINGY,1700,0,0,1,1
GREEDY,3781,16,1,1,18
STINGY,2035,7,0,1,8
STINGY,1995,0,0,0,0
GREEDY,6352,15,2,2,19
STINGY,1347,3,0,1,4
GREEDY,2330,17,2,2,21
GREEDY,9087,15,2,3,20
STINGY,905,3,0,1,4
STINGY,2071,4,0,1,5
STINGY,1695,2,0,0,2
GREEDY,6317,14,1,3,18
GREEDY,1740,11,2,1,14
GREEDY,4006,15,2,4,21
STINGY,1215,2,0,0,2
GREEDY,3070,16,2,3,21
GREEDY,3839,12,2,3,17
GREEDY,3511,14,0,3,17
GREEDY,3571,18,2,3,23
GREEDY,4313,14,1,3,18
GREEDY,16981,16,1,3,20
STINGY,517,4,1,0,5
STINGY,1882,1,0,0,1
GREEDY,3305,16,1,2,19
STINGY,1454,1,0,0,1
STINGY,1620,4,0,2,6
GREEDY,5756,17,2,2,21
GREEDY,4387,18,1,3,22
STINGY,1218,6,0,1,7
GREEDY,1227,16,2,2,20
GREEDY,4449,18,1,4,23
GREEDY,1827,16,2,3,21
STINGY,1440,3,0,0,3
GREEDY,1612,11,1,4,16
GREEDY,6804,16,2,2,20
GREEDY,1374,15,2,3,20
GREEDY,2703,20,2,3,25
GREEDY,5755,16,1,4,21
GREEDY,3486,16,2,4,22
STINGY,1474,3,1,0,4
GREEDY,3332,17,2,3,22
GREEDY,7413,18,2,3,23
STINGY,1309,2,0,1,3
STINGY,1528,2,0,0,2
GREEDY,1593,14,1,2,17
GREEDY,3190,16,2,4,22
GREEDY,5531,12,1,3,16
GREEDY,5010,15,1,2,18
STINGY,1165,5,0,1,6
GREEDY,5829,17,2,3,22
STINGY,1277,2,1,0,3
STINGY,1140,2,1,2,5
GREEDY,2804,16,1,3,20
STINGY,2054,0,0,0,0
STINGY,983,2,0,0,2
STINGY,2690,3,1,1,5
GREEDY,2621,15,2,2,19
GREEDY,1061,10,0,4,14
GREEDY,9274,14,1,4,19
GREEDY,5083,12,2,3,17
GREEDY,3159,14,1,4,19
STINGY,1525,2,0,0,2
GREEDY,1772,12,2,4,18
STINGY,1101,4,0,0,4
GREEDY,2526,17,2,3,22
STINGY,2100,0,0,0,0
GREEDY,3431,15,2,4,21
GREEDY,3177,13,2,3,18
STINGY,1380,3,0,0,3
STINGY,1100,3,1,2,6
GREEDY,2195,12,1,3,16
STINGY,1592,0,0,0,0
GREEDY,1960,16,1,2,19
GREEDY,4706,17,2,4,23
GREEDY,1647,14,2,4,20
GREEDY,5055,15,2,3,20
GREEDY,2017,13,1,4,18
GREEDY,11047,15,1,2,18
STINGY,694,4,1,1,6
STINGY,1675,4,0,1,5
STINGY,1424,2,0,1,3
STINGY,1532,2,0,1,3
GREEDY,3973,16,2,4,22
GREEDY,4236,14,1,4,19
STINGY,1409,5,0,0,5
GREEDY,4397,12,2,4,18
GREEDY,5493,14,2,2,18
GREEDY,4338,15,2,3,20
STINGY,535,5,1,2,8
GREEDY,1965,17,2,4,23
GREEDY,3661,15,2,1,18
GREEDY,2021,17,2,2,21
GREEDY,3150,17,1,3,21
STINGY,1666,4,0,2,6
GREEDY,853,15,2,2,19
STINGY,2100,3,0,2,5
GREEDY,7190,14,2,3,19
STINGY,1541,4,0,2,6
GREEDY,1273,11,1,4,16
GREEDY,2671,14,2,1,17
GREEDY,2433,17,1,2,20
GREEDY,3923,16,0,3,19
STINGY,2048,1,0,0,1
STINGY,1681,2,0,1,3
GREEDY,2420,18,2,2,22
STINGY,1388,2,0,0,2
GREEDY,3365,17,2,3,22
GREEDY,2225,18,2,3,23
STINGY,1574,3,0,0,3
STINGY,1188,2,0,2,4
GREEDY,2737,19,2,3,24
STINGY,1846,4,0,0,4
GREEDY,1661,16,2,3,21
GREEDY,4517,13,2,1,16
STINGY,1493,5,1,1,7
STINGY,1420,1,0,0,1
STINGY,1497,5,0,0,5
STINGY,1079,4,2,2,8
STINGY,1547,4,1,3,8
STINGY,1921,2,1,0,3
,,,,
STINGY,1982,2,1,0,3
STINGY,1918,5,0,1,6
GREEDY,4636,16,2,3,21
GREEDY,4948,15,1,3,19
GREEDY,3263,18,2,2,22
GREEDY,2755,16,2,3,21
GREEDY,3161,16,1,2,19
GREEDY,5252,16,2,3,21
STINGY,1299,3,0,1,4
GREEDY,5537,16,1,3,20
GREEDY,743,16,2,3,21
GREEDY,5637,19,2,3,24
GREEDY,3648,19,1,3,23
GREEDY,3543,16,0,4,20
GREEDY,2236,10,1,4,15
GREEDY,2723,18,2,2,22
GREEDY,3010,15,2,4,21
STINGY,1883,5,0,1,6
GREEDY,2479,18,1,3,22
GREEDY,11128,16,1,2,19
STINGY,1190,4,1,0,5
STINGY,1693,2,0,0,2
STINGY,306,7,0,0,7
GREEDY,4869,14,1,3,18
GREEDY,5206,16,2,3,21
STINGY,1011,5,0,1,6
STINGY,1118,2,0,0,2
GREEDY,3495,16,2,3,21
STINGY,715,3,0,0,3
GREEDY,1395,15,1,4,20
STINGY,1056,7,0,0,7
GREEDY,6061,16,2,4,22
STINGY,1650,4,1,0,5
GREEDY,1594,18,2,3,23
GREEDY,3004,14,2,3,19
STINGY,1500,1,0,0,1
GREEDY,2327,13,1,3,17
STINGY,1610,3,0,0,3
STINGY,1089,4,0,1,5
STINGY,1868,1,0,1,2
GREEDY,4034,17,2,3,22
GREEDY,5043,17,2,3,22
GREEDY,13130,15,1,2,18
GREEDY,5732,17,2,3,22
STINGY,1681,2,0,0,2
GREEDY,5882,14,2,2,18
GREEDY,799,9,1,4,14
STINGY,1513,6,0,0,6
GREEDY,4139,16,2,4,22
STINGY,2881,2,0,0,2
GREEDY,5284,16,2,3,21
STINGY,1392,4,0,2,6
STINGY,1278,1,0,2,3
STINGY,1076,2,0,3,5
GREEDY,1094,11,2,4,17
GREEDY,3595,14,2,4,20
GREEDY,5142,14,2,3,19
GREEDY,1406,19,2,4,25
GREEDY,6896,17,2,3,22
GREEDY,9331,17,1,4,22
GREEDY,3692,18,1,3,22
GREEDY,16002,12,1,2,15
STINGY,557,4,0,1,5
GREEDY,1779,15,1,4,20
STINGY,2229,2,0,1,3
GREEDY,3918,19,2,3,24
GREEDY,3922,14,2,3,19
STINGY,1135,4,0,0,4
GREEDY,3644,16,2,3,21
GREEDY,554,17,2,3,22
GREEDY,1832,17,2,4,23
GREEDY,3748,15,1,3,19
STINGY,2105,6,1,2,9
STINGY,1569,4,1,1,6
GREEDY,3779,16,1,4,21
STINGY,1597,1,1,0,2
GREEDY,5684,14,1,2,17
STINGY,1231,3,0,0,3
GREEDY,4690,17,1,3,21
GREEDY,2821,17,1,4,22
STINGY,1942,1,0,0,1
STINGY,1458,1,2,0,3
STINGY,2254,3,2,3,8
GREEDY,1478,14,1,4,19
GREEDY,3863,18,2,3,23
GREEDY,1606,17,2,4,23
GREEDY,6011,17,2,2,21
STINGY,1620,6,0,1,7
STINGY,1740,2,0,0,2
STINGY,1741,3,0,1,4
GREEDY,3668,14,1,3,18
GREEDY,2932,15,1,3,19
STINGY,1423,1,1,0,2
GREEDY,6192,16,1,3,20
STINGY,1149,3,0,0,3
STINGY,1347,3,0,0,3
GREEDY,2080,11,2,3,16
GREEDY,6234,16,2,3,21
STINGY,1585,2,0,1,3
GREEDY,3787,18,2,2,22
GREEDY,2190,14,0,2,16
GREEDY,3985,18,2,3,23
GREEDY,2417,20,0,4,24
STINGY,1793,5,0,2,7
STINGY,1524,2,0,2,4
STINGY,2145,3,0,1,4
GREEDY,6544,16,1,2,19
GREEDY,1908,17,2,4,23
GREEDY,3821,16,1,2,19
STINGY,906,7,0,1,8
GREEDY,3478,14,2,3,19
GREEDY,2472,19,1,3,23
GREEDY,4943,18,2,2,22
STINGY,1414,1,0,0,1
STINGY,2122,2,0,0,2
GREEDY,1357,13,1,4,18
GREEDY,1674,18,1,3,22
GREEDY,3396,19,1,3,23
STINGY,1552,3,0,2,5
STINGY,1184,4,0,2,6
STINGY,1790,0,0,0,0
STINGY,635,3,1,1,5
GREEDY,4950,14,2,4,20
STINGY,1810,3,0,0,3
GREEDY,5132,16,2,3,21
GREEDY,3528,15,2,3,20
STINGY,1556,5,0,0,5
STINGY,1818,2,1,1,4
GREEDY,4770,19,1,3,23
GREEDY,2325,16,2,2,20
GREEDY,4113,16,2,4,22
GREEDY,6055,19,2,4,25
GREEDY,4128,16,1,3,20
GREEDY,7344,16,0,4,20
GREEDY,1886,15,2,2,19
GREEDY,7620,16,2,2,20
STINGY,1602,4,0,1,5
GREEDY,37041,14,2,2,18
GREEDY,1929,16,2,4,22
STINGY,1787,2,0,1,3
GREEDY,1704,16,2,3,21
GREEDY,2679,19,1,3,23
STINGY,1632,5,0,1,6
GREEDY,1250,16,0,4,20
GREEDY,2216,16,2,3,21
STINGY,1800,1,0,1,2
GREEDY,3404,16,2,4,22
GREEDY,4791,16,1,4,21
GREEDY,4474,17,1,3,21
GREEDY,1746,14,2,2,18
GREEDY,4683,17,2,3,22
STINGY,1936,2,0,2,4
STINGY,1409,2,0,0,2
STINGY,2012,3,0,0,3
,,,,
GREEDY,6632,12,2,4,18
STINGY,1271,2,0,1,3
STINGY,721,5,0,0,5
GREEDY,3307,15,1,2,18
STINGY,1118,2,0,0,2
GREEDY,2296,15,2,4,21
GREEDY,2945,19,2,3,24
GREEDY,3317,13,2,3,18
GREEDY,3744,17,2,2,21
,,,,
STINGY,1920,3,0,1,4
GREEDY,4929,15,2,4,21
GREEDY,4677,16,1,4,21
GREEDY,829,10,1,4,15
GREEDY,7716,16,1,3,20
GREEDY,4490,16,1,2,19
GREEDY,4770,16,2,2,20
STINGY,1345,2,0,1,3
GREEDY,2097,15,2,3,20
STINGY,1559,5,0,0,5
GREEDY,3799,16,1,2,19
GREEDY,4330,17,2,3,22
GREEDY,47801,15,2,2,19
GREEDY,2487,19,2,3,24
GREEDY,7925,16,1,4,21
GREEDY,7404,16,2,1,19
GREEDY,3611,18,0,4,22
STINGY,1810,1,0,0,1
GREEDY,2241,16,2,2,20
GREEDY,6248,18,1,4,23
GREEDY,6323,13,1,3,17
STINGY,1103,4,0,2,6
GREEDY,2212,16,2,3,21
STINGY,1012,3,0,1,4
STINGY,1882,0,0,0,0
STINGY,1718,3,1,0,4
GREEDY,2574,15,1,4,20
GREEDY,7877,13,2,1,16
GREEDY,3202,14,2,4,20
STINGY,1850,0,0,0,0
STINGY,998,4,1,0,5
GREEDY,4586,15,0,3,18
STINGY,1758,2,0,0,2
STINGY,1270,1,0,0,1
STINGY,1812,6,0,1,7
GREEDY,3912,17,2,3,22
GREEDY,4252,15,2,4,21
STINGY,991,5,0,1,6
GREEDY,1564,12,2,4,18
GREEDY,5806,16,1,3,20
GREEDY,3584,14,2,2,18
GREEDY,3260,13,2,3,18
GREEDY,2903,15,1,4,20
GREEDY,2079,15,2,4,21
STINGY,991,5,1,0,6
STINGY,1629,3,0,0,3
STINGY,1818,0,0,0,0
STINGY,1780,3,0,2,5
STINGY,1812,3,1,0,4
GREEDY,2347,17,2,1,20
STINGY,528,4,0,0,4
STINGY,437,3,1,3,7
GREEDY,2802,16,2,2,20
GREEDY,3173,14,2,4,20
STINGY,776,6,0,0,6
GREEDY,5251,16,2,4,22
GREEDY,5044,13,2,4,19
STINGY,2187,4,0,1,5
GREEDY,2624,14,1,4,19
STINGY,1906,5,0,1,6
STINGY,2027,3,1,1,5
GREEDY,5670,14,0,2,16
STINGY,1768,1,0,0,1
GREEDY,8119,13,2,3,18
GREEDY,2385,17,2,4,23
GREEDY,5235,15,2,4,21
GREEDY,6026,16,2,2,20
STINGY,1680,3,0,1,4
GREEDY,1289,18,2,2,22
STINGY,2103,3,1,1,5
GREEDY,2496,12,1,4,17
GREEDY,2143,13,1,3,17
GREEDY,3168,16,1,4,21
STINGY,1383,2,0,0,2
GREEDY,4217,19,2,3,24
STINGY,1679,2,0,0,2
STINGY,1074,3,0,2,5
GREEDY,3498,16,1,3,20
GREEDY,6766,15,2,4,21
GREEDY,3028,17,2,3,22
STINGY,1304,3,0,0,3
STINGY,1524,1,0,0,1
STINGY,1294,3,0,0,3
GREEDY,2766,17,2,2,21
STINGY,912,5,1,0,6
GREEDY,22565,13,2,4,19
STINGY,1586,0,0,0,0
GREEDY,1692,12,1,3,16
GREEDY,11475,15,0,2,17
GREEDY,2060,19,1,3,23
GREEDY,2836,17,1,3,21
STINGY,2042,2,0,0,2
STINGY,1250,3,1,0,4
GREEDY,1756,15,2,3,20
GREEDY,5153,15,2,3,20
GREEDY,6931,16,1,4,21
GREEDY,5345,16,1,2,19
GREEDY,1942,17,2,2,21
GREEDY,708,18,2,3,23
GREEDY,6706,18,2,2,22
GREEDY,3280,14,1,3,18
GREEDY,792,8,0,3,11
GREEDY,3675,17,0,3,20
STINGY,783,5,0,1,6
GREEDY,4257,18,0,2,20
GREEDY,3612,16,2,4,22
GREEDY,1377,17,0,2,19
GREEDY,6254,15,2,3,20
GREEDY,2863,16,2,3,21
GREEDY,6789,17,2,3,22
GREEDY,3857,18,1,2,21
STINGY,1918,2,0,0,2
GREEDY,3774,16,2,3,21
STINGY,1363,2,0,1,3
STINGY,1458,2,0,1,3
STINGY,1766,4,0,1,5
GREEDY,1667,16,0,3,19
STINGY,1725,3,0,1,4
GREEDY,3580,16,0,4,20
GREEDY,4823,13,1,3,17
STINGY,1072,4,0,0,4
GREEDY,5418,15,1,4,20
GREEDY,3905,15,2,2,19
STINGY,1242,3,0,3,6
GREEDY,5624,12,1,4,17
STINGY,1015,5,0,0,5
GREEDY,1998,18,2,4,24
STINGY,1667,3,0,1,4
STINGY,1322,3,0,1,4
GREEDY,3116,15,2,2,19
GREEDY,2303,18,2,3,23
GREEDY,2112,12,1,4,17
STINGY,604,5,0,0,5
GREEDY,1117,18,2,3,23
STINGY,1652,4,1,2,7
GREEDY,2384,15,2,3,20
STINGY,1516,5,1,1,7
GREEDY,1435,16,1,2,19
GREEDY,2238,15,1,4,20
STINGY,1460,2,0,0,2
GREEDY,7576,18,1,2,21
GREEDY,1561,16,2,4,22
STINGY,82735,9,0,1,10
GREEDY,3449,13,2,3,18
GREEDY,1964,8,2,4,14
GREEDY,2474,16,1,2,19
GREEDY,1778,12,1,4,17
STINGY,1786,2,1,1,4
STINGY,1140,5,0,0,5
STINGY,1494,2,0,0,2
GREEDY,2936,15,2,4,21
GREEDY,4437,13,2,4,19
STINGY,2278,0,0,0,0
GREEDY,2404,18,1,2,21
GREEDY,5811,15,2,4,21
STINGY,2484,2,0,2,4
GREEDY,2538,14,2,4,20
GREEDY,8852,13,1,4,18
GREEDY,4697,14,1,4,19
GREEDY,2765,16,1,3,20
GREEDY,2985,20,1,3,24
STINGY,1312,3,1,1,5
STINGY,2066,2,0,0,2
STINGY,1966,0,0,0,0
STINGY,1591,6,1,1,8
STINGY,1484,1,0,1,2
GREEDY,4452,17,1,2,20
GREEDY,4099,16,2,2,20
GREEDY,3625,14,1,4,19
GREEDY,2201,15,1,2,18
GREEDY,4958,17,1,4,22
GREEDY,5934,16,1,3,20
STINGY,1784,3,0,1,4
STINGY,1324,3,1,0,4
STINGY,1612,4,1,0,5
STINGY,1494,0,0,0,0
GREEDY,1866,14,2,4,20
STINGY,2262,2,0,0,2
STINGY,728,4,1,0,5
GREEDY,4526,16,2,2,20
GREEDY,3573,16,2,4,22
GREEDY,2769,15,0,4,19
GREEDY,2443,18,1,3,22
GREEDY,3950,15,2,3,20
GREEDY,5161,15,1,4,20
STINGY,1712,3,1,2,6
GREEDY,3538,16,2,3,21
STINGY,1452,4,1,0,5
STINGY,1568,3,2,0,5
GREEDY,6112,15,0,4,19
GREEDY,5000,15,2,4,21
STINGY,1361,2,0,1,3
STINGY,1210,3,1,1,5
GREEDY,3088,14,2,3,19
STINGY,2035,2,0,0,2
STINGY,1086,4,0,1,5
STINGY,2474,2,0,0,2
GREEDY,6983,16,2,4,22
GREEDY,7289,14,2,4,20
GREEDY,1053,15,2,4,21
GREEDY,3302,17,0,3,20
STINGY,1798,2,1,1,4
GREEDY,1113,10,2,3,15
GREEDY,2062,13,2,2,17
GREEDY,5652,14,2,3,19
GREEDY,3245,17,1,4,22
GREEDY,2963,19,0,2,21
GREEDY,1660,13,2,4,19
GREEDY,3868,16,1,2,19
GREEDY,1532,16,2,4,22
,,,,
STINGY,1992,2,0,1,3
GREEDY,2776,11,2,2,15
GREEDY,2636,15,2,3,20
GREEDY,5576,17,2,3,22
STINGY,1703,1,1,0,2
STINGY,1303,2,0,3,5
GREEDY,7856,16,1,3,20
STINGY,1328,1,0,1,2
GREEDY,4266,15,1,2,18
GREEDY,4992,15,2,3,20
STINGY,1351,3,0,1,4
GREEDY,3080,13,2,4,19
GREEDY,4302,15,1,3,19
GREEDY,2951,18,1,4,23
STINGY,1505,3,1,0,4
GREEDY,2286,16,0,3,19
GREEDY,2633,14,2,3,19
STINGY,1471,3,1,1,5
GREEDY,2339,15,2,2,19
GREEDY,2651,17,2,4,23
GREEDY,594,10,2,3,15
STINGY,1161,2,0,0,2
STINGY,1435,5,0,1,6
GREEDY,4359,17,1,4,22
GREEDY,4632,14,2,3,19
GREEDY,8133,14,2,3,19
GREEDY,2870,16,1,4,21
STINGY,1273,2,0,0,2
GREEDY,6075,16,1,3,20
GREEDY,4536,16,1,2,19
STINGY,1588,3,1,0,4
GREEDY,4360,18,1,4,23
GREEDY,3702,13,2,4,19
STINGY,1573,3,0,0,3
STINGY,1809,2,1,1,4
STINGY,1450,1,0,1,2
STINGY,1926,2,0,0,2
STINGY,1449,0,1,1,2
GREEDY,3980,11,2,3,16
GREEDY,1123,12,1,3,16
GREEDY,6232,15,2,3,20
GREEDY,1513,10,2,4,16
GREEDY,4092,18,2,4,24
GREEDY,3227,15,2,3,20
GREEDY,2827,19,2,3,24
GREEDY,4617,16,2,3,21
STINGY,1634,2,0,0,2
STINGY,1968,0,1,1,2
STINGY,2026,2,0,2,4
GREEDY,3962,19,2,3,24
GREEDY,2676,12,2,4,18
GREEDY,3491,17,2,4,23
GREEDY,1770,15,0,3,18
GREEDY,4363,16,1,4,21
GREEDY,2715,13,2,4,19
STINGY,1693,2,0,0,2
GREEDY,4233,17,1,3,21
GREEDY,4688,17,2,4,23
GREEDY,2625,18,0,4,22
GREEDY,4527,16,1,3,20
GREEDY,1513,13,0,3,16
STINGY,2836,2,1,1,4
STINGY,1245,2,0,0,2
GREEDY,1749,15,0,4,19
STINGY,1827,2,0,0,2
STINGY,982,1,1,0,2
STINGY,1845,0,0,0,0
GREEDY,5656,15,1,3,19
GREEDY,2824,19,2,2,23
GREEDY,8014,16,1,4,21
STINGY,2030,1,0,0,1
STINGY,1186,3,0,0,3
GREEDY,4092,15,2,4,21
STINGY,1807,2,0,0,2
GREEDY,10064,15,2,3,20
GREEDY,2682,13,2,3,18
GREEDY,1313,15,2,4,21
STINGY,1814,0,0,0,0
STINGY,891,6,1,1,8
GREEDY,2523,19,1,3,23
GREEDY,1691,17,0,3,20
GREEDY,5008,13,1,4,18
GREEDY,4979,18,2,4,24
GREEDY,3198,19,2,4,25
GREEDY,2338,16,2,4,22
STINGY,1078,7,0,0,7
GREEDY,3138,16,2,4,22
STINGY,823,5,0,1,6
STINGY,1732,0,0,1,1
GREEDY,2911,18,1,3,22
GREEDY,4366,17,2,3,22
GREEDY,3930,14,2,3,19
GREEDY,10225,15,0,3,18
STINGY,1746,1,0,1,2
GREEDY,1683,16,1,4,21
GREEDY,4981,14,2,1,17
GREEDY,5389,18,1,3,22
GREEDY,2841,17,2,3,22
STINGY,851,3,0,0,3
GREEDY,2777,14,2,2,18
STINGY,679,4,0,2,6
GREEDY,1313,13,1,3,17
GREEDY,3415,14,2,3,19
GREEDY,4270,18,2,4,24
STINGY,2433,4,0,3,7
GREEDY,3315,18,1,1,20
GREEDY,3787,16,2,2,20
GREEDY,6711,15,1,3,19
STINGY,1333,4,0,1,5
GREEDY,2273,19,1,2,22
GREEDY,4636,18,2,2,22
STINGY,995,4,0,0,4
STINGY,640,3,0,1,4
GREEDY,6681,14,2,3,19
GREEDY,3398,16,2,3,21
GREEDY,19774,13,1,3,17
GREEDY,1775,14,2,3,19
STINGY,1560,4,1,0,5
GREEDY,6046,15,2,3,20
GREEDY,3310,12,2,4,18
STINGY,1338,3,0,0,3
STINGY,1943,5,0,1,6
GREEDY,239,7,2,3,12
GREEDY,6561,16,1,2,19
STINGY,1699,1,0,0,1
GREEDY,2731,14,2,2,18
GREEDY,2962,17,2,2,21
GREEDY,1068,7,1,4,12
GREEDY,4685,19,0,2,21
GREEDY,4871,16,2,4,22
STINGY,1719,0,0,1,1
STINGY,1526,6,0,3,9
STINGY,1606,9,1,0,10
STINGY,639,4,0,2,6
GREEDY,8110,15,1,2,18
GREEDY,4140,15,2,3,20
GREEDY,4700,16,2,4,22
GREEDY,2333,18,1,3,22
STINGY,916,6,0,1,7
GREEDY,2163,17,2,4,23
GREEDY,22577,16,2,2,20
STINGY,1501,3,0,0,3
STINGY,1556,3,0,0,3
GREEDY,2495,13,1,4,18
GREEDY,2793,17,2,4,23
GREEDY,8189,15,0,3,18
STINGY,2069,1,1,0,2
GREEDY,3168,15,2,4,21
GREEDY,5238,15,2,2,19
STINGY,1836,1,0,0,1
STINGY,1748,1,0,0,1
GREEDY,5365,16,2,2,20
STINGY,1619,3,0,1,4
GREEDY,5248,15,2,3,20
STINGY,1473,1,0,1,2
STINGY,1597,1,1,1,3
GREEDY,3954,13,1,4,18
GREEDY,3298,15,0,3,18
GREEDY,5000,14,2,3,19
GREEDY,2514,15,1,4,20
STINGY,1382,0,0,0,0
GREEDY,1916,15,1,4,20
GREEDY,5184,15,2,3,20
STINGY,1316,3,0,1,4
GREEDY,2451,12,1,2,15
GREEDY,6911,14,1,3,18
STINGY,1519,2,1,0,3
GREEDY,3172,16,2,3,21
GREEDY,2862,16,1,3,20
GREEDY,2016,11,2,4,17
GREEDY,3070,17,2,2,21
STINGY,1199,2,0,0,2
STINGY,1793,3,0,1,4
STINGY,1479,3,0,2,5
STINGY,1747,4,0,1,5
GREEDY,8212,13,2,2,17
STINGY,1466,1,0,0,1
GREEDY,4985,16,2,3,21
GREEDY,2087,15,1,3,19
STINGY,1668,0,1,1,2
GREEDY,2602,19,2,4,25
GREEDY,3141,17,2,3,22
STINGY,1032,3,0,1,4
STINGY,2277,6,0,3,9
GREEDY,11597,14,1,3,18
GREEDY,2391,17,1,4,22
GREEDY,4991,16,1,3,20
GREEDY,2039,13,2,4,19
GREEDY,3620,16,1,4,21
GREEDY,2278,15,2,4,21
STINGY,951,6,0,0,6
STINGY,1301,4,1,0,5
GREEDY,5332,16,2,2,20
GREEDY,18624,15,1,3,19
STINGY,2386,4,0,3,7
GREEDY,2210,17,1,3,21
STINGY,549,5,0,0,5
GREEDY,3941,17,2,3,22
GREEDY,2080,16,2,3,21
GREEDY,910,10,2,4,16
GREEDY,3682,15,2,3,20
STINGY,1492,4,0,0,4
GREEDY,3465,17,2,1,20
GREEDY,4730,15,2,3,20
STINGY,1846,0,0,2,2
GREEDY,7804,15,2,3,20
GREEDY,8750,15,1,2,18
GREEDY,5730,15,2,2,19
GREEDY,5737,15,2,3,20
GREEDY,2328,16,0,4,20
GREEDY,4359,17,2,2,21
GREEDY,2374,16,2,3,21
STINGY,1692,3,0,0,3
GREEDY,2809,14,2,2,18
STINGY,854,6,1,0,7
GREEDY,2559,15,2,3,20
STINGY,1880,3,1,1,5
GREEDY,1776,20,1,2,23
GREEDY,4557,13,2,3,18
STINGY,1017,4,1,1,6
STINGY,2297,3,0,0,3
STINGY,1048,3,0,1,4
GREEDY,6744,15,2,2,19
STINGY,1223,7,1,3,11
STINGY,1045,3,1,0,4
GREEDY,5854,16,1,3,20
GREEDY,3005,19,2,4,25
GREEDY,3328,13,1,1,15
STINGY,1411,2,0,0,2
STINGY,1507,3,1,0,4
GREEDY,3760,14,2,3,19
GREEDY,9172,14,2,2,18
GREEDY,4393,11,1,3,15
GREEDY,2977,20,1,3,24
GREEDY,2374,14,1,4,19
GREEDY,2097,14,2,1,17
GREEDY,2437,15,2,2,19
STINGY,1226,4,0,1,5
STINGY,1540,1,0,0,1
STINGY,318,7,1,1,9
GREEDY,8099,15,2,3,20
GREEDY,6543,15,1,3,19
GREEDY,1758,14,1,2,17
STINGY,1969,3,0,2,5
GREEDY,3949,15,1,2,18
STINGY,1320,2,1,1,4
GREEDY,1204,12,2,2,16
STINGY,1473,1,0,1,2
GREEDY,3841,15,2,3,20
STINGY,1166,2,1,2,5
GREEDY,3807,15,1,4,20
GREEDY,2455,16,2,2,20
GREEDY,2514,17,2,3,22
GREEDY,4178,15,2,2,19
STINGY,1772,3,0,1,4
STINGY,991,1,0,1,2
GREEDY,5821,15,2,2,19
STINGY,1611,2,0,1,3
GREEDY,6800,16,1,4,21
GREEDY,1635,17,2,4,23
GREEDY,5248,17,2,3,22
STINGY,1127,5,1,0,6
STINGY,1261,2,0,1,3
STINGY,1590,4,1,1,6
GREEDY,2723,14,2,4,20
STINGY,1948,1,0,0,1
STINGY,1378,1,0,0,1
GREEDY,2551,17,1,4,22
GREEDY,2206,16,1,2,19
,,,,
GREEDY,2462,16,1,3,20
STINGY,1043,3,0,3,6
GREEDY,3519,17,1,3,21
GREEDY,2725,18,0,3,21
STINGY,1772,1,0,0,1
GREEDY,2244,18,2,4,24
GREEDY,1744,14,1,4,19
STINGY,860,4,0,1,5
STINGY,1119,2,0,0,2
GREEDY,2706,16,2,4,22
STINGY,1417,1,0,0,1
GREEDY,2820,15,0,3,18
GREEDY,2084,17,2,4,23
STINGY,2181,5,0,1,6
GREEDY,5276,18,1,2,21
STINGY,1484,3,1,2,6
GREEDY,3422,18,2,3,23
GREEDY,2554,16,0,2,18
STINGY,143,4,0,3,7
STINGY,2116,1,0,0,1
STINGY,1751,5,1,1,7
GREEDY,1902,16,2,3,21
STINGY,1630,3,0,0,3
GREEDY,4450,17,2,3,22
GREEDY,3513,18,2,3,23
STINGY,1402,5,0,0,5
GREEDY,1662,17,2,2,21
GREEDY,3107,17,1,3,21
GREEDY,5078,16,1,4,21
GREEDY,3298,16,1,2,19
GREEDY,6332,15,2,2,19
GREEDY,6299,15,1,3,19
STINGY,1138,5,0,0,5
GREEDY,4634,15,2,3,20
GREEDY,6926,13,0,4,17
STINGY,1367,3,1,1,5
STINGY,1886,2,0,0,2
GREEDY,4589,14,2,3,19
GREEDY,3353,16,2,3,21
GREEDY,3342,18,2,4,24
GREEDY,4154,15,2,2,19
GREEDY,4556,14,2,4,20
GREEDY,2574,14,1,3,18
GREEDY,1804,16,1,4,21
GREEDY,2085,13,2,2,17
STINGY,1580,1,1,0,2
STINGY,1838,1,1,0,2
STINGY,1542,2,1,1,4
GREEDY,3082,16,2,4,22
STINGY,2247,0,0,0,0
STINGY,1386,4,2,0,6
STINGY,1558,4,1,1,6
STINGY,1586,6,0,0,6
GREEDY,2042,15,2,4,21
GREEDY,3997,16,2,2,20
STINGY,1222,2,1,1,4
GREEDY,3436,15,2,4,21
STINGY,1810,1,1,0,2
STINGY,1346,4,1,1,6
STINGY,2370,0,0,0,0
GREEDY,4818,13,1,2,16
GREEDY,3035,17,1,2,20
GREEDY,5095,17,1,3,21
GREEDY,2186,17,1,2,20
GREEDY,3445,16,2,2,20
STINGY,2516,4,1,1,6
GREEDY,2646,15,2,3,20
GREEDY,5483,17,2,3,22
STINGY,1342,2,0,0,2
GREEDY,1662,18,2,4,24
GREEDY,8096,16,2,3,21
GREEDY,4189,16,2,2,20
GREEDY,4713,16,2,2,20
STINGY,1866,2,0,1,3
GREEDY,4703,17,1,2,20
GREEDY,5662,14,0,3,17
GREEDY,4914,15,2,4,21
GREEDY,4892,16,1,3,20
STINGY,1682,0,0,1,1
GREEDY,2299,15,1,3,19
GREEDY,1338,17,1,3,21
GREEDY,3007,14,2,4,20
GREEDY,1944,16,1,4,21
GREEDY,4444,16,2,2,20
STINGY,1345,6,1,1,8
STINGY,2246,3,0,0,3
GREEDY,3718,16,1,4,21
STINGY,1677,2,1,1,4
GREEDY,3611,14,1,4,19
GREEDY,7957,16,2,2,20
STINGY,1434,3,0,1,4
GREEDY,5840,16,2,4,22
GREEDY,5420,15,1,2,18
STINGY,1253,5,1,2,8
STINGY,1635,3,0,0,3
STINGY,1212,3,1,0,4
GREEDY,7908,15,1,3,19
GREEDY,2315,18,2,3,23
STINGY,2208,2,1,1,4
STINGY,1504,1,0,2,3
GREEDY,1348,13,1,4,18
GREEDY,7676,15,2,1,18
GREEDY,1745,17,2,3,22
STINGY,1289,3,0,1,4
STINGY,1570,3,0,0,3
GREEDY,4802,16,1,2,19
GREEDY,2834,16,1,3,20
STINGY,1680,2,1,0,3
STINGY,1404,3,1,2,6
GREEDY,4104,18,1,4,23
GREEDY,5677,15,1,4,20
GREEDY,3403,15,2,1,18
GREEDY,9781,14,2,3,19
GREEDY,3064,13,2,2,17
STINGY,2301,3,0,0,3
GREEDY,3187,15,1,4,20
GREEDY,4524,15,1,2,18
STINGY,2562,5,2,0,7
GREEDY,2648,16,2,4,22
GREEDY,4631,18,1,2,21
GREEDY,2830,14,2,3,19
STINGY,2667,5,1,3,9
STINGY,1029,4,1,1,6
STINGY,1395,3,0,1,4
GREEDY,2477,17,1,3,21
STINGY,1336,6,0,1,7
STINGY,1485,4,0,0,4
GREEDY,4558,17,2,4,23
STINGY,1341,3,0,1,4
STINGY,1580,5,1,2,8
GREEDY,2524,14,1,2,17
STINGY,2337,1,0,2,3
GREEDY,2890,16,2,4,22
GREEDY,2396,17,1,4,22
STINGY,1555,0,1,2,3
STINGY,1172,2,0,0,2
STINGY,995,5,0,3,8
GREEDY,2662,14,2,2,18
GREEDY,2752,16,2,2,20
GREEDY,1683,16,1,4,21
GREEDY,1917,15,1,4,20
GREEDY,6022,16,1,2,19
GREEDY,8060,16,2,3,21
GREEDY,2242,17,2,2,21
STINGY,896,6,0,2,8
GREEDY,8673,16,0,2,18
GREEDY,3293,18,2,3,23
STINGY,862,6,0,1,7
STINGY,1348,2,0,0,2
GREEDY,2026,14,1,4,19
GREEDY,1782,14,2,4,20
STINGY,1584,5,1,0,6
GREEDY,2248,16,0,4,20
GREEDY,2743,18,2,4,24
STINGY,1442,4,0,1,5
GREEDY,3192,18,2,3,23
GREEDY,4081,15,1,3,19
STINGY,1974,1,0,0,1
GREEDY,13582,16,1,3,20
GREEDY,4845,18,1,4,23
GREEDY,3211,14,2,4,20
GREEDY,5905,17,0,4,21
GREEDY,3167,14,2,1,17
GREEDY,1574,13,2,3,18
GREEDY,3568,17,2,3,22
GREEDY,1469,16,2,1,19
STINGY,2502,6,0,0,6
GREEDY,4733,14,1,2,17
GREEDY,2585,14,2,4,20
GREEDY,3481,17,1,3,21
GREEDY,2076,16,2,3,21
GREEDY,8363,16,1,3,20
GREEDY,2403,13,1,4,18
GREEDY,9748,13,2,3,18
STINGY,1609,2,0,0,2
STINGY,1190,0,0,1,1
STINGY,656,7,0,0,7
GREEDY,2904,16,2,3,21
STINGY,2255,6,0,1,7
GREEDY,3796,18,0,3,21
STINGY,1592,1,0,0,1
GREEDY,6114,16,2,3,21
GREEDY,4118,16,1,3,20
STINGY,1884,1,0,0,1
GREEDY,8118,16,1,3,20
GREEDY,939,14,1,4,19
GREEDY,7708,15,2,3,20
STINGY,2083,4,1,1,6
STINGY,1883,2,0,0,2
STINGY,1251,6,1,0,7
GREEDY,1528,16,1,4,21
GREEDY,2160,17,1,2,20
GREEDY,3098,15,1,3,19
GREEDY,2159,19,0,1,20
STINGY,456,4,0,1,5
STINGY,1236,4,1,0,5
GREEDY,3446,16,1,3,20
GREEDY,2494,18,2,3,23
GREEDY,983,19,2,2,23
STINGY,988,3,1,2,6
GREEDY,5312,21,1,3,25
STINGY,2090,3,0,0,3
GREEDY,29920,13,1,4,18
STINGY,886,1,1,1,3
GREEDY,3439,14,1,3,18
STINGY,1613,3,1,1,5
GREEDY,2303,11,2,2,15
GREEDY,5450,15,1,3,19
STINGY,1973,0,0,2,2
STINGY,1528,3,2,0,5
STINGY,904,3,1,1,5
STINGY,1455,0,0,1,1
STINGY,1442,3,0,0,3
STINGY,1829,2,1,0,3
GREEDY,6871,17,2,3,22
STINGY,2085,0,1,1,2
GREEDY,5126,15,2,4,21
STINGY,1037,2,0,0,2
GREEDY,12717,15,2,1,18
STINGY,1074,4,0,1,5
GREEDY,3905,17,2,3,22
STINGY,1298,2,0,0,2
GREEDY,3612,13,1,1,15
STINGY,1914,1,0,0,1
GREEDY,3730,15,2,3,20
GREEDY,2935,14,1,2,17
STINGY,1635,2,1,1,4
GREEDY,3482,15,1,3,19
GREEDY,5218,16,2,2,20
STINGY,1242,4,1,1,6
STINGY,1387,10,0,2,12
STINGY,1019,3,0,0,3
STINGY,1832,1,0,0,1
GREEDY,2183,19,2,2,23
GREEDY,1889,15,1,3,19
GREEDY,4284,15,2,2,19
GREEDY,2150,16,1,2,19
STINGY,1525,3,0,0,3
GREEDY,7492,13,2,3,18
STINGY,1314,3,1,1,5
STINGY,881,3,1,1,5
STINGY,1700,2,0,1,3
STINGY,1014,3,1,1,5
GREEDY,3440,14,2,3,19
GREEDY,317,9,2,3,14
GREEDY,17654,14,0,3,17
STINGY,1485,3,0,0,3
STINGY,1544,1,0,0,1
GREEDY,2382,17,2,4,23
GREEDY,2911,16,1,3,20
STINGY,980,5,0,1,6
STINGY,1366,4,1,2,7
GREEDY,3460,16,2,4,22
STINGY,2204,6,0,2,8
GREEDY,9238,16,2,3,21
GREEDY,2103,15,2,4,21
GREEDY,1326,13,2,3,18
STINGY,888,1,1,1,3
GREEDY,2656,15,2,3,20
STINGY,1405,1,0,1,2
GREEDY,6468,17,2,2,21
GREEDY,7916,16,2,4,22
GREEDY,2563,17,1,3,21
STINGY,1368,2,0,1,3
GREEDY,3779,16,2,3,21
GREEDY,3177,12,2,4,18
STINGY,1605,0,0,0,0
GREEDY,9566,17,2,2,21
GREEDY,3154,16,2,4,22
STINGY,486,7,0,2,9
GREEDY,4669,16,2,4,22
STINGY,1136,7,0,0,7
STINGY,757,3,0,1,4
STINGY,1617,2,0,0,2
GREEDY,2770,16,2,3,21
STINGY,2379,5,0,2,7
STINGY,1754,4,0,1,5
GREEDY,1810,10,2,3,15
STINGY,1248,3,0,0,3
GREEDY,1117,11,2,3,16
GREEDY,3288,15,1,3,19
STINGY,1234,3,1,0,4
GREEDY,5221,17,2,2,21
GREEDY,4353,17,1,3,21
STINGY,1876,4,1,1,6
GREEDY,4115,15,2,3,20
GREEDY,1880,14,2,4,20
GREEDY,3237,18,2,3,23
GREEDY,2369,11,2,4,17
STINGY,824,3,0,1,4
STINGY,2040,2,0,2,4
GREEDY,3510,16,2,4,22
GREEDY,3928,15,1,3,19
GREEDY,5510,14,1,4,19
GREEDY,1017,16,1,2,19
STINGY,1391,3,0,0,3
STINGY,1364,2,0,2,4
GREEDY,3131,15,1,3,19
STINGY,1656,3,0,1,4
GREEDY,8060,17,2,4,23
GREEDY,687,15,2,4,21
GREEDY,3353,15,2,3,20
GREEDY,3121,17,2,4,23
GREEDY,3438,14,1,4,19
STINGY,900,3,0,0,3
GREEDY,12858,14,1,3,18
GREEDY,5684,19,2,3,24
GREEDY,3229,16,1,3,20
GREEDY,3931,12,1,4,17
STINGY,1594,4,1,2,7
GREEDY,1686,18,1,4,23
STINGY,739,5,0,1,6
GREEDY,6736,18,2,3,23
STINGY,738,3,0,2,5
GREEDY,2196,16,2,4,22
GREEDY,9882,11,2,4,17
GREEDY,6158,19,2,2,23
GREEDY,2671,16,1,3,20
STINGY,1721,4,0,1,5
GREEDY,5600,17,2,3,22
STINGY,1686,2,0,1,3
STINGY,1788,1,0,0,1
GREEDY,1952,16,2,3,21
GREEDY,3327,13,2,4,19
STINGY,712,4,0,2,6
GREEDY,3541,18,2,3,23
GREEDY,2798,19,2,1,22
GREEDY,3192,16,2,3,21
STINGY,1472,3,0,0,3
STINGY,980,7,1,0,8
STINGY,1324,3,0,1,4
GREEDY,2007,15,1,4,20
STINGY,1260,6,0,1,7
GREEDY,3611,18,1,4,23
STINGY,1424,3,0,0,3
GREEDY,4888,13,1,3,17
GREEDY,92460,13,1,4,18
STINGY,1630,4,2,0,6
GREEDY,5462,16,2,3,21
GREEDY,3504,13,2,3,18
GREEDY,6580,16,2,2,20
GREEDY,2235,17,1,4,22
GREEDY,2162,17,1,4,22
GREEDY,3398,14,1,2,17
STINGY,784,7,0,0,7
GREEDY,3230,15,2,3,20
GREEDY,15118,14,1,2,17
GREEDY,2516,15,2,2,19
STINGY,1421,4,0,1,5
GREEDY,3337,17,2,3,22
GREEDY,5283,19,2,3,24
GREEDY,7444,15,1,3,19
GREEDY,3167,19,1,3,23
GREEDY,1161,10,1,4,15
GREEDY,3944,17,2,3,22
GREEDY,2720,18,2,3,23
GREEDY,595,8,2,4,14
STINGY,2600,4,0,3,7
GREEDY,4678,13,2,2,17
GREEDY,4737,14,2,3,19
GREEDY,2707,16,2,3,21
GREEDY,1686,16,2,1,19
STINGY,1639,3,0,2,5
STINGY,1880,2,0,0,2
STINGY,1400,1,0,0,1
GREEDY,3213,18,1,3,22
GREEDY,5191,19,2,2,23
GREEDY,4767,19,1,2,22
GREEDY,2301,12,1,4,17
GREEDY,3915,14,2,4,20
STINGY,1388,2,0,1,3
STINGY,1090,4,0,2,6
GREEDY,2681,15,2,3,20
GREEDY,1382,13,0,4,17
GREEDY,5601,14,2,3,19
GREEDY,722,15,1,3,19
GREEDY,2809,16,1,3,20
GREEDY,1990,19,2,3,24
GREEDY,2636,9,0,4,13
GREEDY,2397,13,1,3,17
STINGY,979,2,1,1,4
GREEDY,3720,18,2,3,23
GREEDY,3585,16,2,4,22
GREEDY,3536,17,2,3,22
STINGY,958,7,1,0,8
GREEDY,1492,18,1,3,22
GREEDY,4785,19,2,3,24
STINGY,1329,3,0,1,4
STINGY,1586,3,1,0,4
GREEDY,1850,15,2,4,21
STINGY,1418,5,0,2,7
STINGY,1037,4,0,0,4
STINGY,1172,2,1,0,3
GREEDY,7162,15,2,3,20
GREEDY,1702,15,1,2,18
STINGY,940,3,2,2,7
GREEDY,4390,15,2,3,20
GREEDY,3143,15,2,3,20
STINGY,1718,4,1,1,6
STINGY,1412,1,1,0,2
STINGY,1949,2,0,0,2
STINGY,1813,0,0,1,1
STINGY,1722,3,0,0,3
GREEDY,2454,15,1,4,20
GREEDY,2596,15,1,3,19
STINGY,1446,3,1,1,5
GREEDY,2401,17,0,4,21
GREEDY,1432,17,2,4,23
GREEDY,5190,16,1,3,20
GREEDY,5743,16,2,3,21
GREEDY,2748,18,2,4,24
STINGY,1648,2,0,1,3
STINGY,1510,3,0,1,4
STINGY,2116,5,0,1,6
GREEDY,2746,16,1,2,19
STINGY,1505,4,1,1,6
GREEDY,3274,16,2,2,20
STINGY,3107,4,1,3,8
GREEDY,4837,11,2,4,17
STINGY,1370,3,0,0,3
STINGY,1527,2,0,1,3
GREEDY,622,10,0,4,14
STINGY,886,4,0,0,4
STINGY,1436,3,0,0,3
GREEDY,3030,17,2,4,23
STINGY,893,8,0,1,9
STINGY,1377,3,1,0,4
GREEDY,484,11,1,1,13
GREEDY,4980,19,2,4,25
GREEDY,3952,18,1,4,23
GREEDY,7542,16,2,3,21
STINGY,1287,1,1,1,3
STINGY,1502,2,0,0,2
GREEDY,3883,15,2,4,21
GREEDY,2445,15,2,4,21
GREEDY,1730,11,2,3,16
GREEDY,3011,16,2,3,21
GREEDY,2155,18,2,4,24
STINGY,1166,2,0,0,2
STINGY,1996,1,0,1,2
GREEDY,4024,18,1,3,22
GREEDY,11122,15,2,3,20
STINGY,1731,3,0,0,3
GREEDY,4810,17,2,3,22
GREEDY,8918,16,2,2,20
GREEDY,3077,16,2,2,20
GREEDY,2871,14,1,4,19
GREEDY,4288,17,1,3,21
GREEDY,2010,15,2,4,21
GREEDY,4576,15,2,3,20
STINGY,1680,2,0,0,2
STINGY,1063,1,1,0,2
STINGY,1272,3,0,2,5
STINGY,834,3,0,2,5
GREEDY,2355,17,1,4,22
STINGY,2436,1,1,0,2
GREEDY,4368,18,2,3,23
GREEDY,6460,19,2,4,25
GREEDY,5418,15,2,3,20
STINGY,1818,4,0,1,5
STINGY,1989,4,0,0,4
STINGY,1007,5,0,0,5
STINGY,871,4,0,1,5
STINGY,1567,5,0,0,5
GREEDY,2378,12,2,3,17
STINGY,1445,1,0,1,2
GREEDY,3530,16,2,3,21
STINGY,2137,2,0,0,2
STINGY,1030,2,0,1,3
GREEDY,3817,15,1,4,20
STINGY,1537,3,0,0,3
STINGY,1326,2,0,0,2
STINGY,1357,3,0,1,4
GREEDY,4644,15,1,4,20
STINGY,1268,3,0,0,3
GREEDY,9636,17,2,3,22
GREEDY,1497,16,1,3,20
GREEDY,3333,15,2,3,20
STINGY,2248,1,1,0,2
STINGY,1475,2,1,2,5
GREEDY,2624,13,1,4,18
GREEDY,2743,13,1,4,18
GREEDY,7819,18,2,2,22
STINGY,2066,0,0,0,0
GREEDY,2985,14,2,4,20
GREEDY,8835,12,2,4,18
GREEDY,2915,17,2,4,23
STINGY,1213,3,0,0,3
,,,,
,,,,
GREEDY,2513,16,2,4,22
GREEDY,780,15,2,3,20
GREEDY,2549,17,1,3,21
GREEDY,2710,18,1,3,22
GREEDY,3677,16,2,2,20
GREEDY,7849,15,2,2,19
STINGY,1618,1,0,0,1
STINGY,1530,3,0,0,3
GREEDY,1502,12,0,4,16
GREEDY,6649,15,2,3,20
STINGY,1251,5,1,2,8
STINGY,1560,1,0,0,1
STINGY,1272,4,0,1,5
GREEDY,1619,17,2,2,21
STINGY,1230,3,0,0,3
GREEDY,1934,17,2,4,23
GREEDY,7082,18,2,2,22
GREEDY,5227,17,1,1,19
GREEDY,2753,15,2,2,19
STINGY,1068,3,0,1,4
STINGY,1599,1,0,0,1
GREEDY,10601,15,2,2,19
GREEDY,3122,16,2,3,21
GREEDY,10706,16,2,3,21
GREEDY,1651,13,1,4,18
GREEDY,4816,16,2,4,22
GREEDY,2470,15,2,2,19
GREEDY,8474,15,2,3,20
GREEDY,3439,15,1,2,18
GREEDY,2108,18,2,4,24
GREEDY,14894,15,1,3,19
GREEDY,2622,16,1,4,21
STINGY,1868,3,1,3,7
STINGY,1510,0,0,1,1
GREEDY,3244,17,2,3,22
STINGY,1210,2,0,0,2
GREEDY,2481,18,1,3,22
GREEDY,3011,14,2,4,20
GREEDY,2742,16,1,4,21
GREEDY,2747,14,2,4,20
GREEDY,1585,16,1,2,19
STINGY,1782,5,1,1,7
STINGY,760,4,1,0,5
STINGY,1348,4,0,3,7
GREEDY,7817,15,1,4,20
STINGY,2050,1,0,0,1
GREEDY,4369,16,2,3,21
GREEDY,1380,18,1,3,22
GREEDY,2606,17,2,4,23
GREEDY,3981,18,2,2,22
GREEDY,1458,11,2,4,17
GREEDY,3030,14,2,3,19
GREEDY,5920,15,0,3,18
STINGY,1360,2,0,1,3
STINGY,980,2,0,0,2
GREEDY,5043,12,2,4,18
STINGY,1856,1,0,1,2
STINGY,1590,1,0,0,1
STINGY,2454,2,0,0,2
GREEDY,686,12,2,3,17
GREEDY,982,13,0,4,17
STINGY,1701,2,0,1,3
STINGY,1220,3,0,0,3
GREEDY,2954,14,2,4,20
GREEDY,8069,17,1,3,21
STINGY,1521,3,1,0,4
GREEDY,2947,18,0,2,20
GREEDY,1755,14,2,4,20
GREEDY,623,14,2,3,19
GREEDY,3851,17,2,3,22
GREEDY,3794,15,1,3,19
STINGY,1048,5,2,0,7
STINGY,1513,5,0,2,7
STINGY,766,6,0,1,7
STINGY,1799,4,0,0,4
GREEDY,9673,15,2,2,19
STINGY,1476,2,0,0,2
GREEDY,5677,15,1,2,18
STINGY,1560,1,0,1,2
