strategy,money,countries,utilities,stations,totalLandsOwned
STINGY,712,5,1,0,6
STINGY,914,8,0,0,8
GREEDY,3345,18,1,2,21
STINGY,1675,4,0,0,4
STINGY,1702,2,2,0,4
GREEDY,2766,15,1,4,20
STINGY,1234,2,0,1,3
STINGY,1420,3,0,0,3
,,,,
STINGY,1417,2,0,1,3
STINGY,745,7,0,0,7
GREEDY,3366,15,2,3,20
GREEDY,2048,12,2,3,17
STINGY,1366,2,0,0,2
GREEDY,3277,15,1,4,20
STINGY,1792,2,0,0,2
GREEDY,1413,18,2,3,23
STINGY,1811,5,0,0,5
STINGY,1436,4,0,0,4
GREEDY,9428,16,1,3,20
GREEDY,838,14,2,4,20
STINGY,1406,4,0,0,4
STINGY,905,3,0,2,5
GREEDY,5446,16,2,3,21
GREEDY,2710,12,1,4,17
GREEDY,5701,13,2,3,18
GREEDY,4430,17,1,3,21
GREEDY,5325,15,1,2,18
GREEDY,2793,14,1,4,19
STINGY,1446,6,0,0,6
STINGY,1545,4,1,1,6
GREEDY,1895,14,1,4,19
GREEDY,1865,16,2,3,21
STINGY,1260,4,0,1,5
GREEDY,1950,14,1,4,19
STINGY,1660,2,1,0,3
STINGY,1660,0,0,0,0
STINGY,1262,3,0,0,3
GREEDY,4141,17,2,3,22
GREEDY,3265,14,2,2,18
GREEDY,1480,12,1,3,16
STINGY,2745,2,0,0,2
GREEDY,2998,16,0,4,20
GREEDY,4332,18,2,2,22
GREEDY,1560,18,2,4,24
GREEDY,3019,15,2,3,20
STINGY,1882,0,0,0,0
GREEDY,2737,15,2,3,20
GREEDY,3508,19,1,4,24
STINGY,1900,0,0,0,0
GREEDY,2108,18,1,2,21
STINGY,1733,4,0,1,5
STINGY,1421,2,0,0,2
GREEDY,2089,16,1,2,19
GREEDY,701,12,1,3,16
GREEDY,5562,14,1,3,18
GREEDY,4674,16,2,4,22
GREEDY,5856,16,0,3,19
GREEDY,4031,17,0,3,20
GREEDY,4530,19,1,3,23
STINGY,1859,1,0,1,2
GREEDY,3550,16,2,4,22
GREEDY,7603,14,2,3,19
STINGY,1402,3,1,0,4
GREEDY,3618,15,2,4,21
STINGY,1421,3,0,1,4
GREEDY,1360,15,2,2,19
STINGY,1769,0,0,1,1
GREEDY,2136,18,2,3,23
GREEDY,4750,17,1,2,20
GREEDY,2771,14,2,4,20
STINGY,1453,3,0,1,4
STINGY,1132,3,1,1,5
GREEDY,4166,17,1,4,22
STINGY,1730,3,0,0,3
STINGY,1339,5,0,1,6
STINGY,1538,2,0,0,2
GREEDY,6531,18,1,2,21
GREEDY,5062,17,1,4,22
GREEDY,2904,13,2,3,18
STINGY,1656,4,0,0,4
STINGY,1802,1,0,1,2
STINGY,1035,4,0,0,4
STINGY,1242,4,0,2,6
STINGY,1189,1,0,2,3
STINGY,856,3,0,0,3
GREEDY,5051,18,1,4,23
STINGY,750,3,1,3,7
STINGY,1592,3,0,0,3
GREEDY,2560,17,0,1,18
GREEDY,5836,17,2,2,21
STINGY,1603,2,0,0,2
GREEDY,5232,16,2,4,22
GREEDY,3319,18,0,3,21
GREEDY,7249,17,2,2,21
GREEDY,2335,17,2,2,21
GREEDY,5435,13,2,3,18
GREEDY,1695,18,1,4,23
GREEDY,2884,15,2,3,20
STINGY,1698,2,1,2,5
STINGY,930,3,0,0,3
GREEDY,7083,13,2,3,18
GREEDY,3358,14,2,3,19
GREEDY,1698,10,2,2,14
GREEDY,10000,15,2,3,20
STINGY,1670,3,0,0,3
STINGY,1411,4,1,0,5
STINGY,1614,4,1,0,5
GREEDY,2254,17,2,4,23
GREEDY,4149,14,2,2,18
STINGY,1772,3,0,0,3
GREEDY,5371,17,2,3,22
GREEDY,6507,16,2,4,22
GREEDY,3714,17,2,3,22
GREEDY,7878,14,1,4,19
GREEDY,4572,18,1,4,23
GREEDY,3821,13,2,3,18
GREEDY,3487,16,0,3,19
GREEDY,1834,15,1,3,19
GREEDY,3146,18,1,4,23
GREEDY,7912,14,2,3,19
GREEDY,9137,17,2,4,23
GREEDY,7919,14,1,3,18
STINGY,1892,6,0,1,7
STINGY,1686,2,0,3,5
STINGY,1180,4,1,0,5
STINGY,1300,5,0,0,5
STINGY,1335,3,0,1,4
GREEDY,7038,15,2,3,20
GREEDY,5558,17,2,2,21
GREEDY,3462,11,2,4,17
STINGY,1787,3,0,0,3
GREEDY,1145,18,1,4,23
STINGY,1600,2,0,0,2
STINGY,1212,7,0,2,9
GREEDY,5003,19,2,2,23
GREEDY,2385,18,2,3,23
GREEDY,8849,18,2,3,23
STINGY,2148,2,0,0,2
STINGY,2340,0,0,0,0
STINGY,1316,5,0,3,8
GREEDY,4056,17,2,3,22
GREEDY,6676,12,1,3,16
GREEDY,2800,17,2,4,23
STINGY,2294,3,0,0,3
GREEDY,10426,16,1,4,21
STINGY,1615,0,0,0,0
STINGY,1223,3,1,0,4
GREEDY,3463,17,1,2,20
GREEDY,4262,15,2,4,21
GREEDY,4906,17,2,3,22
GREEDY,6103,12,2,4,18
STINGY,2046,2,0,0,2
GREEDY,4463,19,2,4,25
STINGY,1146,7,0,2,9
STINGY,830,5,1,1,7
GREEDY,7987,16,1,3,20
STINGY,1678,3,0,1,4
STINGY,1331,5,1,0,6
GREEDY,3946,15,1,3,19
GREEDY,4500,18,2,4,24
GREEDY,4113,15,2,4,21
GREEDY,2347,16,2,4,22
GREEDY,4031,14,2,4,20
STINGY,1983,1,0,0,1
GREEDY,3074,14,1,4,19
GREEDY,1575,17,1,3,21
GREEDY,4957,15,1,3,19
GREEDY,4761,18,2,2,22
GREEDY,2755,16,0,4,20
STINGY,618,5,1,3,9
GREEDY,2588,15,2,1,18
STINGY,2297,2,2,0,4
GREEDY,4903,16,2,3,21
GREEDY,1328,19,0,2,21
STINGY,1394,2,0,0,2
STINGY,1745,0,0,0,0
STINGY,1115,3,0,1,4
GREEDY,2040,19,2,4,25
GREEDY,3153,18,2,3,23
STINGY,1120,4,0,0,4
STINGY,1611,2,0,0,2
GREEDY,3095,16,2,4,22
GREEDY,5603,17,2,3,22
GREEDY,8063,16,2,2,20
STINGY,1421,2,1,0,3
GREEDY,1828,17,1,4,22
GREEDY,4203,13,2,3,18
GREEDY,3061,16,2,3,21
GREEDY,2361,16,2,2,20
STINGY,1580,1,1,1,3
STINGY,1508,0,0,1,1
STINGY,1621,3,0,1,4
GREEDY,2657,15,1,4,20
GREEDY,2282,13,2,4,19
STINGY,2123,3,2,2,7
GREEDY,1159,9,2,4,15
GREEDY,4289,17,2,2,21
GREEDY,1702,14,2,3,19
GREEDY,2204,21,0,2,23
GREEDY,2383,16,0,4,20
STINGY,1871,2,0,1,3
GREEDY,3347,15,1,4,20
STINGY,1560,2,0,0,2
STINGY,1647,4,0,0,4
STINGY,938,4,0,0,4
STINGY,1331,4,0,1,5
STINGY,1686,2,0,2,4
STINGY,1811,3,0,0,3
GREEDY,5089,17,2,4,23
STINGY,1125,5,0,1,6
STINGY,1102,1,0,2,3
GREEDY,7142,16,1,3,20
GREEDY,3778,18,1,4,23
STINGY,1005,2,1,1,4
GREEDY,5166,15,1,3,19
GREEDY,3756,18,2,3,23
STINGY,1620,1,0,1,2
STINGY,3085,5,2,1,8
GREEDY,2012,16,1,3,20
GREEDY,4285,13,2,3,18
STINGY,1555,2,0,1,3
STINGY,913,5,0,1,6
STINGY,1015,1,0,1,2
GREEDY,6567,16,1,3,20
STINGY,1614,1,0,0,1
GREEDY,2944,17,1,3,21
GREEDY,3735,18,2,2,22
STINGY,1552,4,0,1,5
STINGY,1248,3,0,0,3
GREEDY,2903,16,1,4,21
STINGY,1398,4,0,1,5
GREEDY,4140,16,1,3,20
GREEDY,3952,18,2,3,23
GREEDY,4247,14,2,3,19
GREEDY,1790,13,1,4,18
STINGY,1652,3,0,1,4
STINGY,1286,2,0,1,3
GREEDY,2244,17,1,3,21
GREEDY,5829,13,1,2,16
STINGY,1921,2,0,0,2
STINGY,1355,6,0,3,9
GREEDY,5056,16,2,2,20
STINGY,1765,3,0,0,3
GREEDY,1174,8,1,3,12
STINGY,1462,2,1,0,3
STINGY,1342,2,0,2,4
GREEDY,2433,17,2,2,21
STINGY,1948,0,0,1,1
GREEDY,3095,17,2,2,21
GREEDY,3622,14,2,4,20
GREEDY,3345,18,1,2,21
STINGY,1032,2,0,1,3
GREEDY,7092,15,1,2,18
GREEDY,2849,16,1,3,20
STINGY,1717,0,0,3,3
STINGY,1475,8,0,1,9
GREEDY,1858,17,2,3,22
STINGY,1405,2,0,1,3
GREEDY,3712,14,2,1,17
STINGY,1732,1,1,0,2
STINGY,1376,2,1,2,5
STINGY,1213,1,1,1,3
STINGY,744,5,0,0,5
GREEDY,2405,15,1,3,19
GREEDY,7237,15,2,3,20
STINGY,1348,4,1,1,6
GREEDY,2996,18,1,3,22
GREEDY,13022,14,2,4,20
GREEDY,6956,17,2,2,21
GREEDY,1832,15,1,2,18
,,,,
STINGY,1565,2,0,0,2
STINGY,1384,3,1,2,6
STINGY,1405,5,1,2,8
STINGY,1382,1,0,1,2
STINGY,1562,1,0,0,1
GREEDY,2353,14,2,4,20
GREEDY,5284,15,2,2,19
GREEDY,1132,13,1,4,18
GREEDY,3523,18,2,2,22
STINGY,1410,2,0,0,2
GREEDY,2946,15,1,3,19
GREEDY,3179,17,2,3,22
STINGY,1507,3,0,0,3
GREEDY,2650,14,2,3,19
STINGY,1424,3,0,1,4
STINGY,866,6,0,0,6
STINGY,1575,2,0,0,2
STINGY,1536,1,0,0,1
STINGY,1110,3,0,1,4
GREEDY,5368,15,1,2,18
GREEDY,2980,16,1,2,19
STINGY,2397,4,0,1,5
GREEDY,2025,18,2,3,23
STINGY,1658,2,1,0,3
GREEDY,1201,13,0,3,16
STINGY,1310,1,0,1,2
STINGY,1695,2,1,0,3
GREEDY,3369,17,2,2,21
STINGY,879,6,0,1,7
GREEDY,4404,18,2,2,22
STINGY,1410,2,0,0,2
GREEDY,2109,19,2,3,24
GREEDY,2906,15,2,4,21
GREEDY,4704,14,2,3,19
GREEDY,1896,16,2,4,22
GREEDY,4937,17,1,3,21
GREEDY,1454,14,0,3,17
GREEDY,3763,16,1,3,20
GREEDY,1467,14,2,4,20
GREEDY,1615,16,2,4,22
GREEDY,3359,15,2,3,20
GREEDY,4339,16,2,3,21
GREEDY,3402,14,2,2,18
GREEDY,2246,17,0,4,21
STINGY,246,5,0,1,6
STINGY,2258,2,0,2,4
STINGY,1700,0,0,0,0
STINGY,881,7,0,0,7
GREEDY,3418,18,1,3,22
STINGY,807,4,0,0,4
GREEDY,4750,15,2,3,20
GREEDY,8744,17,1,1,19
GREEDY,4389,19,1,3,23
STINGY,1494,1,0,0,1
GREEDY,1256,14,2,3,19
GREEDY,4646,15,1,3,19
GREEDY,3492,15,2,2,19
GREEDY,3247,15,1,4,20
GREEDY,5156,18,2,3,23
STINGY,642,3,1,0,4
STINGY,1304,3,1,0,4
GREEDY,2360,17,1,1,19
STINGY,1312,1,0,0,1
GREEDY,2500,15,2,4,21
GREEDY,7787,16,2,3,21
GREEDY,5408,17,1,2,20
STINGY,2152,2,0,0,2
STINGY,1730,3,0,1,4
GREEDY,4294,18,2,2,22
GREEDY,3760,16,2,3,21
STINGY,1494,2,0,0,2
GREEDY,4906,17,1,3,21
STINGY,2385,3,1,0,4
STINGY,184,6,0,1,7
STINGY,620,5,0,1,6
GREEDY,2781,16,1,3,20
STINGY,1580,1,0,1,2
STINGY,1424,2,0,0,2
STINGY,1767,3,0,0,3
GREEDY,4173,15,1,3,19
STINGY,2407,2,0,3,5
GREEDY,1124,15,1,2,18
STINGY,965,4,1,1,6
STINGY,840,4,0,0,4
STINGY,98457,11,1,1,13
GREEDY,2484,18,1,3,22
GREEDY,4834,16,1,4,21
GREEDY,3593,17,1,3,21
GREEDY,1445,11,1,4,16
GREEDY,6066,16,2,3,21
GREEDY,11861,15,1,2,18
STINGY,1310,7,0,2,9
GREEDY,15557,16,2,2,20
GREEDY,541,15,1,4,20
STINGY,1906,1,1,0,2
GREEDY,1317,16,2,4,22
STINGY,1861,4,0,2,6
GREEDY,4084,15,2,3,20
STINGY,1406,2,0,2,4
GREEDY,3017,19,1,2,22
STINGY,1341,1,0,0,1
GREEDY,2499,16,2,3,21
STINGY,1548,6,0,0,6
GREEDY,3351,18,2,3,23
GREEDY,1994,14,2,2,18
STINGY,575,4,1,0,5
GREEDY,4858,14,2,4,20
GREEDY,4595,14,2,1,17
STINGY,1833,4,0,0,4
GREEDY,1674,14,1,4,19
GREEDY,3639,14,1,4,19
GREEDY,4045,16,1,3,20
GREEDY,1453,15,1,3,19
STINGY,1462,5,0,1,6
STINGY,1177,1,0,0,1
GREEDY,4178,18,1,2,21
STINGY,1455,2,1,0,3
GREEDY,4437,17,2,2,21
GREEDY,16048,14,2,2,18
STINGY,2092,3,0,0,3
GREEDY,3867,17,2,2,21
GREEDY,1336,14,2,2,18
GREEDY,2659,17,2,2,21
STINGY,1654,3,0,1,4
GREEDY,2381,15,1,2,18
GREEDY,7122,16,1,4,21
STINGY,2238,2,0,0,2
STINGY,1373,4,0,0,4
GREEDY,4532,17,2,4,23
GREEDY,5032,17,2,2,21
GREEDY,1707,9,2,4,15
STINGY,536,7,1,1,9
STINGY,1404,2,0,0,2
GREEDY,9565,15,2,3,20
GREEDY,3430,18,2,2,22
GREEDY,3198,13,1,3,17
STINGY,1198,4,0,1,5
GREEDY,2981,19,1,3,23
STINGY,1642,2,0,0,2
GREEDY,3268,18,2,2,22
GREEDY,2688,17,2,4,23
GREEDY,5424,15,1,4,20
STINGY,1154,4,1,0,5
GREEDY,3808,16,1,1,18
GREEDY,6857,14,2,3,19
GREEDY,4303,18,0,3,21
GREEDY,17200,14,2,3,19
GREEDY,452,14,1,3,18
GREEDY,2187,16,1,2,19
GREEDY,13927,16,2,3,21
GREEDY,3830,16,1,4,21
GREEDY,3568,17,1,3,21
STINGY,1003,5,1,1,7
GREEDY,5699,17,2,2,21
GREEDY,3653,16,2,1,19
STINGY,1278,1,0,1,2
STINGY,890,5,1,0,6
GREEDY,3992,16,2,3,21
GREEDY,2245,19,2,3,24
GREEDY,1534,14,1,4,19
GREEDY,1762,17,1,3,21
GREEDY,1805,12,1,2,15
GREEDY,4784,15,1,4,20
STINGY,1665,3,0,0,3
STINGY,1586,0,0,1,1
GREEDY,5122,20,1,3,24
GREEDY,3253,15,2,4,21
GREEDY,2821,19,1,3,23
GREEDY,3040,17,1,2,20
GREEDY,614,11,1,4,16
STINGY,1416,2,0,2,4
GREEDY,3161,16,1,3,20
GREEDY,3652,12,2,3,17
STINGY,1705,2,0,0,2
STINGY,1218,5,0,1,6
GREEDY,6998,16,2,4,22
GREEDY,7321,15,2,4,21
GREEDY,2488,18,1,4,23
STINGY,1366,0,0,1,1
GREEDY,4243,16,2,2,20
STINGY,1399,7,0,1,8
GREEDY,2778,18,1,4,23
GREEDY,2555,15,1,4,20
STINGY,1745,1,0,0,1
GREEDY,3525,17,2,0,19
STINGY,947,2,0,1,3
GREEDY,3342,17,2,4,23
GREEDY,3872,16,2,2,20
GREEDY,1399,16,1,4,21
STINGY,797,4,0,0,4
GREEDY,2412,18,2,2,22
GREEDY,2336,13,2,2,17
GREEDY,4814,13,2,4,19
GREEDY,2488,20,2,2,24
STINGY,1416,2,0,2,4
GREEDY,11415,14,2,3,19
GREEDY,3644,16,2,3,21
GREEDY,4773,18,1,3,22
GREEDY,2903,15,1,4,20
GREEDY,4253,18,2,3,23
GREEDY,6638,16,1,2,19
STINGY,2319,4,0,0,4
STINGY,1083,2,0,1,3
STINGY,861,7,0,1,8
GREEDY,3037,15,1,4,20
STINGY,990,2,0,0,2
GREEDY,3479,18,1,2,21
STINGY,1515,3,1,0,4
GREEDY,6879,15,1,3,19
GREEDY,3747,16,1,3,20
STINGY,1315,4,0,2,6
GREEDY,2379,14,2,3,19
GREEDY,823,17,1,4,22
STINGY,1137,4,2,0,6
GREEDY,3753,16,2,2,20
STINGY,936,3,0,1,4
STINGY,1176,5,0,0,5
STINGY,618,3,0,1,4
GREEDY,6114,18,1,3,22
STINGY,2269,2,0,2,4
STINGY,1043,4,0,1,5
GREEDY,718,14,1,3,18
GREEDY,2665,17,2,3,22
STINGY,1606,3,0,2,5
STINGY,608,4,0,0,4
GREEDY,3279,16,1,4,21
GREEDY,3841,17,1,3,21
STINGY,1702,2,0,1,3
GREEDY,6989,17,1,3,21
GREEDY,4418,17,1,3,21
STINGY,1049,6,0,2,8
GREEDY,8336,15,1,3,19
STINGY,2066,4,0,1,5
STINGY,1500,4,1,0,5
GREEDY,4309,15,2,3,20
GREEDY,2461,18,2,2,22
GREEDY,3369,18,0,4,22
STINGY,1351,4,1,3,8
GREEDY,1905,15,1,4,20
GREEDY,2888,15,2,3,20
GREEDY,5750,14,2,4,20
GREEDY,1302,14,2,3,19
STINGY,1438,5,1,1,7
STINGY,1338,3,0,0,3
STINGY,1496,2,1,0,3
GREEDY,3380,14,2,4,20
STINGY,1769,3,0,0,3
GREEDY,7688,13,2,1,16
STINGY,2367,2,0,1,3
GREEDY,4076,15,2,3,20
GREEDY,3695,17,1,3,21
STINGY,2252,4,1,1,6
STINGY,2041,2,0,0,2
STINGY,1612,5,1,0,6
,,,,
STINGY,1689,2,1,1,4
GREEDY,1673,17,2,2,21
GREEDY,3076,16,1,3,20
GREEDY,2498,17,2,3,22
GREEDY,2591,18,2,0,20
GREEDY,2825,16,2,4,22
GREEDY,5486,17,1,3,21
GREEDY,5655,16,2,4,22
STINGY,2448,3,0,2,5
GREEDY,3257,14,1,4,19
STINGY,1359,5,0,2,7
STINGY,1851,5,1,1,7
GREEDY,2035,16,2,3,21
STINGY,1312,1,0,1,2
GREEDY,4937,13,1,3,17
STINGY,1092,3,0,0,3
STINGY,1157,1,0,0,1
GREEDY,2018,17,1,3,21
GREEDY,2544,15,2,3,20
STINGY,1481,2,0,0,2
GREEDY,2238,13,1,4,18
STINGY,809,3,0,1,4
GREEDY,8482,16,2,2,20
STINGY,1997,0,0,0,0
GREEDY,1928,16,1,4,21
GREEDY,10520,13,2,4,19
GREEDY,3128,13,1,2,16
STINGY,1476,1,0,0,1
GREEDY,2924,14,2,3,19
STINGY,1494,2,0,1,3
GREEDY,6402,15,2,2,19
GREEDY,1294,14,1,3,18
STINGY,1819,3,0,1,4
GREEDY,3253,15,1,2,18
STINGY,1236,4,0,1,5
GREEDY,2981,19,2,3,24
GREEDY,1527,19,1,3,23
GREEDY,6268,15,2,3,20
STINGY,1808,4,0,0,4
STINGY,1993,3,0,2,5
GREEDY,4368,15,1,2,18
STINGY,1794,2,1,0,3
GREEDY,4570,16,1,4,21
STINGY,1654,0,0,0,0
GREEDY,4893,15,2,2,19
GREEDY,9263,16,1,4,21
STINGY,1048,1,0,1,2
STINGY,1808,0,0,0,0
GREEDY,1531,13,2,4,19
STINGY,1553,4,0,1,5
GREEDY,3909,18,2,3,23
GREEDY,3569,16,2,3,21
GREEDY,1155,18,1,3,22
GREEDY,991,15,2,3,20
GREEDY,2188,15,2,3,20
STINGY,1664,1,1,0,2
GREEDY,3261,12,2,4,18
GREEDY,1792,17,2,2,21
GREEDY,8389,14,1,4,19
GREEDY,5712,13,2,4,19
GREEDY,1977,18,1,3,22
GREEDY,6209,18,0,2,20
STINGY,1408,5,1,1,7
GREEDY,3360,16,2,3,21
GREEDY,3889,15,1,3,19
GREEDY,3107,13,2,4,19
GREEDY,8423,16,2,2,20
GREEDY,2125,17,2,3,22
STINGY,1863,1,0,0,1
STINGY,1915,2,0,0,2
GREEDY,2423,16,1,4,21
STINGY,2184,1,0,0,1
STINGY,1194,4,0,0,4
STINGY,2010,2,0,1,3
STINGY,969,4,0,0,4
GREEDY,4404,19,1,3,23
GREEDY,5096,15,0,2,17
GREEDY,4192,16,2,2,20
STINGY,1150,1,1,1,3
STINGY,1664,4,0,1,5
GREEDY,3238,14,2,3,19
GREEDY,2355,14,1,4,19
GREEDY,3966,18,2,3,23
GREEDY,3542,17,2,3,22
GREEDY,3324,15,2,2,19
GREEDY,2047,11,2,4,17
GREEDY,1663,14,1,3,18
GREEDY,3165,18,2,3,23
GREEDY,3924,15,1,1,17
STINGY,1788,1,0,0,1
STINGY,1908,3,0,0,3
GREEDY,3536,12,2,4,18
GREEDY,7610,17,0,4,21
GREEDY,4810,16,1,4,21
GREEDY,2140,15,2,3,20
GREEDY,1413,13,1,4,18
GREEDY,2019,14,2,4,20
GREEDY,2551,18,2,4,24
STINGY,1924,5,0,2,7
GREEDY,2848,16,2,3,21
GREEDY,2957,15,2,4,21
STINGY,1981,1,0,0,1
STINGY,1462,3,1,0,4
STINGY,1754,4,0,0,4
GREEDY,1716,16,2,4,22
GREEDY,7949,15,1,2,18
GREEDY,3073,18,1,2,21
STINGY,1667,3,0,0,3
GREEDY,4654,17,1,4,22
STINGY,1807,4,0,1,5
GREEDY,3276,15,2,4,21
GREEDY,1116,16,1,2,19
GREEDY,6065,15,2,3,20
GREEDY,6343,14,1,4,19
GREEDY,2757,17,2,2,21
GREEDY,5348,14,2,3,19
STINGY,2093,2,1,0,3
STINGY,1410,5,0,0,5
STINGY,1597,5,0,1,6
STINGY,1808,3,0,0,3
STINGY,1750,0,0,0,0
GREEDY,1347,12,2,4,18
GREEDY,2605,17,1,2,20
GREEDY,2646,17,2,3,22
GREEDY,8624,13,2,2,17
STINGY,1260,3,0,1,4
GREEDY,6012,15,2,1,18
STINGY,1410,1,0,1,2
GREEDY,1948,14,2,4,20
GREEDY,7433,14,1,3,18
STINGY,1881,2,0,1,3
GREEDY,3586,15,1,4,20
GREEDY,2474,15,2,4,21
GREEDY,2793,18,1,3,22
STINGY,1289,4,1,0,5
GREEDY,5812,14,0,3,17
GREEDY,2077,19,2,4,25
STINGY,1688,0,0,2,2
GREEDY,2575,17,2,3,22
GREEDY,1979,18,1,4,23
STINGY,1040,3,1,0,4
STINGY,1621,5,0,2,7
GREEDY,5137,16,0,3,19
GREEDY,4915,16,2,4,22
GREEDY,4495,19,2,3,24
GREEDY,4270,14,1,4,19
STINGY,1527,4,0,1,5
STINGY,1296,3,0,0,3
GREEDY,4229,14,2,4,20
GREEDY,6230,14,1,4,19
STINGY,1379,4,0,2,6
GREEDY,1236,10,2,1,13
STINGY,672,4,1,3,8
STINGY,2356,5,2,3,10
GREEDY,2257,14,1,2,17
GREEDY,4749,15,2,4,21
STINGY,2966,4,0,2,6
STINGY,1896,3,0,0,3
STINGY,1688,1,0,0,1
STINGY,1398,3,1,0,4
GREEDY,4923,16,1,2,19
GREEDY,4853,17,1,4,22
STINGY,1732,6,0,2,8
GREEDY,3632,17,1,3,21
STINGY,1872,4,0,2,6
STINGY,1038,2,0,3,5
GREEDY,8559,15,2,4,21
GREEDY,2805,14,2,3,19
GREEDY,1415,19,2,2,23
GREEDY,5901,16,2,2,20
GREEDY,640,10,1,2,13
GREEDY,4591,14,1,3,18
GREEDY,2186,15,2,4,21
GREEDY,1592,14,1,4,19
GREEDY,4446,19,0,1,20
GREEDY,1334,19,2,3,24
STINGY,1624,1,0,2,3
STINGY,833,5,1,0,6
GREEDY,4219,17,2,3,22
STINGY,1056,5,0,1,6
STINGY,1433,2,1,1,4
GREEDY,3771,14,1,3,18
STINGY,1653,1,0,0,1
STINGY,1459,8,2,2,12
STINGY,1489,2,0,0,2
GREEDY,3579,15,2,4,21
GREEDY,2351,18,1,2,21
GREEDY,2845,16,2,3,21
STINGY,1752,8,1,0,9
STINGY,1230,5,1,1,7
STINGY,1140,4,0,0,4
GREEDY,5774,18,1,3,22
GREEDY,2533,16,1,3,20
GREEDY,4150,18,2,2,22
GREEDY,1956,15,1,4,20
STINGY,1192,3,0,1,4
GREEDY,3671,14,2,4,20
GREEDY,2879,17,1,3,21
STINGY,1580,2,1,1,4
STINGY,1094,6,0,1,7
STINGY,1197,3,0,1,4
STINGY,960,3,1,0,4
GREEDY,3860,16,1,4,21
GREEDY,1491,15,0,3,18
STINGY,1235,1,0,1,2
GREEDY,1176,15,1,4,20
STINGY,1569,3,0,1,4
STINGY,1307,2,0,1,3
STINGY,363,3,0,2,5
GREEDY,1681,15,2,4,21
GREEDY,2938,13,2,4,19
GREEDY,1973,18,1,3,22
STINGY,1724,0,0,0,0
GREEDY,2656,17,2,4,23
STINGY,1408,5,0,1,6
GREEDY,4510,16,1,3,20
GREEDY,383,13,2,3,18
STINGY,1613,2,1,1,4
STINGY,1858,1,0,0,1
GREEDY,3218,16,1,1,18
STINGY,1570,1,1,1,3
GREEDY,443,17,1,4,22
STINGY,822,3,1,2,6
GREEDY,12854,16,1,2,19
GREEDY,3695,16,2,1,19
STINGY,2620,1,0,0,1
GREEDY,1122,15,2,4,21
GREEDY,1764,18,2,3,23
GREEDY,9925,15,2,2,19
GREEDY,3517,13,2,3,18
GREEDY,1244,13,1,4,18
STINGY,1017,4,0,1,5
GREEDY,1176,16,2,3,21
STINGY,847,4,0,1,5
STINGY,2692,3,0,1,4
GREEDY,3682,13,2,2,17
GREEDY,843,11,1,4,16
STINGY,2188,2,0,1,3
GREEDY,3576,16,1,3,20
GREEDY,1422,18,2,3,23
GREEDY,2773,17,1,4,22
STINGY,1494,2,0,0,2
GREEDY,8509,17,2,1,20
GREEDY,2571,19,2,3,24
GREEDY,6115,16,0,2,18
GREEDY,1160,14,1,3,18
GREEDY,4222,14,2,3,19
STINGY,1824,1,0,0,1
GREEDY,7685,14,2,3,19
STINGY,1392,2,0,0,2
GREEDY,3065,18,1,2,21
STINGY,1560,2,0,0,2
GREEDY,13459,13,1,3,17
GREEDY,3172,16,2,3,21
STINGY,2264,2,0,1,3
GREEDY,4000,17,1,3,21
STINGY,1802,0,0,0,0
GREEDY,1948,14,2,3,19
GREEDY,1662,13,0,4,17
GREEDY,4057,18,1,3,22
GREEDY,6315,18,1,4,23
STINGY,1174,4,1,0,5
GREEDY,3735,19,2,1,22
STINGY,38310,10,0,2,12
GREEDY,3159,17,2,1,20
STINGY,1146,3,1,2,6
STINGY,750,5,0,1,6
GREEDY,11508,14,1,2,17
GREEDY,1562,16,2,3,21
STINGY,24246,11,0,0,11
GREEDY,3115,15,1,4,20
GREEDY,4289,18,2,3,23
STINGY,1305,3,0,1,4
GREEDY,2772,14,2,4,20
GREEDY,1524,13,1,4,18
GREEDY,7692,15,1,2,18
STINGY,1710,1,0,0,1
GREEDY,1683,13,2,4,19
STINGY,1631,4,1,2,7
GREEDY,3165,14,2,2,18
STINGY,2574,3,2,1,6
GREEDY,4091,18,2,3,23
STINGY,1034,3,1,4,8
STINGY,1426,2,0,2,4
GREEDY,9572,16,1,3,20
STINGY,1614,4,1,2,7
GREEDY,4859,15,2,3,20
GREEDY,1116,19,2,4,25
GREEDY,4114,16,2,3,21
GREEDY,2210,13,2,2,17
GREEDY,1813,19,2,3,24
GREEDY,2525,18,2,2,22
STINGY,1675,0,0,1,1
GREEDY,3676,18,2,4,24
STINGY,949,3,0,0,3
GREEDY,2752,19,2,2,23
GREEDY,3796,18,1,2,21
GREEDY,10530,15,1,2,18
GREEDY,3654,15,2,3,20
STINGY,1314,3,1,2,6
GREEDY,2283,14,1,4,19
STINGY,1586,1,1,0,2
STINGY,1122,2,1,0,3
GREEDY,4023,16,2,3,21
STINGY,2059,3,0,0,3
STINGY,2223,2,1,1,4
GREEDY,1884,15,1,4,20
GREEDY,4490,17,1,3,21
STINGY,2560,3,1,1,5
STINGY,1358,2,0,2,4
STINGY,1048,6,0,1,7
GREEDY,918,12,1,4,17
GREEDY,5956,14,2,3,19
STINGY,1628,1,0,0,1
STINGY,1482,1,0,0,1
GREEDY,1273,18,2,3,23
GREEDY,3686,17,2,1,20
STINGY,1003,5,0,0,5
GREEDY,1037,11,2,4,17
GREEDY,3439,16,1,3,20
GREEDY,7645,15,1,3,19
STINGY,1124,3,0,1,4
GREEDY,3360,17,2,3,22
STINGY,1731,3,0,1,4
GREEDY,2239,12,1,4,17
GREEDY,3039,16,2,4,22
GREEDY,4699,16,2,3,21
STINGY,1602,4,1,0,5
GREEDY,3574,16,1,4,21
STINGY,1210,1,1,1,3
GREEDY,3565,13,2,4,19
STINGY,2288,1,0,1,2
GREEDY,3369,16,2,4,22
STINGY,2498,7,2,2,11
STINGY,1476,1,0,0,1
STINGY,1481,2,0,0,2
GREEDY,4902,16,0,4,20
STINGY,1228,1,0,1,2
GREEDY,2715,14,2,3,19
STINGY,1157,3,0,1,4
STINGY,1045,4,0,2,6
STINGY,4228,8,0,1,9
STINGY,1507,0,0,1,1
STINGY,1059,5,0,1,6
GREEDY,886,12,1,4,17
STINGY,1178,3,0,1,4
GREEDY,6175,13,1,3,17
GREEDY,1747,14,1,4,19
STINGY,1368,4,1,2,7
GREEDY,1792,17,2,3,22
GREEDY,9398,15,2,3,20
STINGY,791,3,0,0,3
GREEDY,2312,16,1,3,20
GREEDY,3651,17,2,3,22
STINGY,849,5,0,1,6
STINGY,1219,7,0,0,7
STINGY,1803,0,0,1,1
GREEDY,1358,15,2,4,21
GREEDY,3532,17,1,4,22
GREEDY,1581,16,2,3,21
,,,,
GREEDY,2705,16,1,4,21
STINGY,2804,3,1,2,6
STINGY,846,5,0,1,6
GREEDY,3974,15,1,3,19
GREEDY,3014,15,2,3,20
GREEDY,3967,15,2,3,20
STINGY,2239,5,0,0,5
GREEDY,344,14,2,3,19
STINGY,1558,1,1,1,3
GREEDY,14309,14,1,3,18
STINGY,1100,2,1,2,5
GREEDY,4428,13,1,4,18
GREEDY,1712,19,2,3,24
STINGY,1957,2,0,0,2
STINGY,968,3,0,0,3
GREEDY,5378,17,2,3,22
GREEDY,2530,17,1,3,21
STINGY,1881,3,1,1,5
GREEDY,8408,16,1,3,20
GREEDY,4108,17,2,4,23
STINGY,1521,4,0,0,4
GREEDY,7245,18,1,2,21
GREEDY,5102,15,1,3,19
STINGY,1655,2,0,0,2
GREEDY,8287,15,0,3,18
STINGY,1482,2,2,2,6
GREEDY,3225,17,2,3,22
GREEDY,1092,14,0,4,18
GREEDY,5053,17,2,3,22
STINGY,1614,6,0,3,9
STINGY,1460,5,0,1,6
GREEDY,7353,15,2,3,20
STINGY,1482,4,0,1,5
GREEDY,3146,18,1,2,21
GREEDY,2658,17,1,3,21
GREEDY,8120,17,1,3,21
STINGY,556,6,0,2,8
GREEDY,14532,13,2,4,19
GREEDY,2028,13,1,4,18
GREEDY,3539,14,2,3,19
GREEDY,3076,16,2,3,21
GREEDY,4859,15,2,4,21
GREEDY,4179,13,2,4,19
STINGY,1098,4,0,0,4
GREEDY,5228,14,2,3,19
STINGY,1058,1,0,2,3
GREEDY,4531,13,2,2,17
GREEDY,2223,16,2,1,19
GREEDY,3695,15,2,3,20
STINGY,250,6,0,0,6
GREEDY,4328,15,1,3,19
GREEDY,3031,16,1,4,21
GREEDY,4928,16,2,2,20
STINGY,1515,3,0,0,3
STINGY,1854,5,2,1,8
GREEDY,6786,12,1,2,15
STINGY,1327,6,0,1,7
GREEDY,4625,14,0,3,17
GREEDY,3391,15,0,3,18
STINGY,1605,4,0,0,4
GREEDY,3200,13,2,3,18
GREEDY,6930,14,1,3,18
GREEDY,30150,16,1,2,19
STINGY,1412,4,0,1,5
,,,,
GREEDY,3435,15,2,4,21
GREEDY,2713,16,2,3,21
GREEDY,172,11,2,1,14
STINGY,2008,3,1,1,5
GREEDY,4977,19,2,2,23
STINGY,1552,3,0,1,4
GREEDY,3755,18,1,3,22
GREEDY,3691,16,2,3,21
GREEDY,2429,17,2,4,23
GREEDY,8197,15,2,3,20
GREEDY,4321,14,2,4,20
GREEDY,6263,17,1,4,22
GREEDY,2435,18,2,2,22
STINGY,1428,2,0,2,4
GREEDY,3217,18,2,3,23
STINGY,1764,0,0,0,0
,,,,
GREEDY,6056,16,1,3,20
STINGY,1919,5,0,2,7
STINGY,1414,2,0,0,2
GREEDY,9768,14,2,2,18
GREEDY,5472,17,2,2,21
STINGY,1217,5,0,2,7
GREEDY,3306,17,1,2,20
STINGY,1656,2,1,0,3
STINGY,1059,3,0,1,4
GREEDY,1901,14,2,4,20
GREEDY,7486,14,2,2,18
GREEDY,8159,14,2,2,18
GREEDY,3401,15,1,4,20
STINGY,1462,1,0,0,1
GREEDY,2859,13,2,3,18
GREEDY,1024,14,1,3,18
STINGY,1241,7,1,1,9
STINGY,1723,5,0,0,5
GREEDY,5568,18,1,3,22
STINGY,2147,3,0,0,3
GREEDY,9902,19,1,2,22
STINGY,1320,2,0,0,2
GREEDY,4051,14,2,3,19
GREEDY,7388,15,2,4,21
GREEDY,3365,15,1,2,18
GREEDY,1401,15,2,4,21
GREEDY,2288,14,0,3,17
GREEDY,4080,17,1,3,21
STINGY,1257,1,1,0,2
GREEDY,3376,15,2,3,20
STINGY,1402,5,0,1,6
STINGY,2312,5,0,1,6
STINGY,1225,2,1,1,4
GREEDY,2635,15,2,3,20
GREEDY,8859,15,2,2,19
GREEDY,3436,17,2,1,20
GREEDY,4177,15,1,3,19
GREEDY,4702,17,2,2,21
STINGY,1224,3,0,1,4
GREEDY,4622,18,2,3,23
GREEDY,1450,14,2,3,19
GREEDY,4504,16,2,1,19
STINGY,1400,3,0,0,3
GREEDY,2236,16,1,3,20
GREEDY,8106,19,1,2,22
STINGY,1424,5,0,2,7
GREEDY,4242,17,2,2,21
STINGY,1184,2,0,0,2
GREEDY,974,13,2,3,18
STINGY,1065,2,0,0,2
GREEDY,3074,13,1,3,17
GREEDY,3572,17,2,4,23
STINGY,1519,1,1,1,3
STINGY,1585,3,0,1,4
GREEDY,4428,17,1,3,21
STINGY,2287,1,0,1,2
STINGY,1517,2,0,0,2
STINGY,1859,3,0,1,4
STINGY,1878,1,0,0,1
GREEDY,4070,17,1,3,21
STINGY,1275,4,1,4,9
GREEDY,2918,17,1,2,20
GREEDY,2371,18,0,3,21
GREEDY,3281,18,1,3,22
GREEDY,1471,13,1,3,17
STINGY,1685,3,1,0,4
STINGY,1664,3,1,0,4
GREEDY,6008,15,1,4,20
STINGY,1436,3,1,2,6
GREEDY,1322,13,2,4,19
GREEDY,4016,16,2,1,19
STINGY,2270,1,2,1,4
GREEDY,3770,15,1,4,20
GREEDY,3906,16,2,3,21
GREEDY,2142,13,1,2,16
STINGY,582,4,0,0,4
GREEDY,2909,15,2,3,20
GREEDY,4451,17,2,4,23
STINGY,995,2,0,0,2
STINGY,1650,2,0,0,2
GREEDY,2585,14,1,3,18
GREEDY,3359,16,2,4,22
STINGY,2195,1,0,0,1
GREEDY,8029,17,2,2,21
STINGY,1286,4,1,0,5
GREEDY,3230,17,2,3,22
STINGY,950,4,0,0,4
STINGY,1184,3,0,1,4
STINGY,1779,4,0,0,4
STINGY,1454,6,1,0,7
STINGY,1465,3,2,1,6
STINGY,1004,5,1,1,7
STINGY,1768,2,0,1,3
GREEDY,3280,13,1,3,17
STINGY,912,6,0,1,7
STINGY,1327,5,1,1,7
STINGY,236,4,0,2,6
GREEDY,2945,15,2,3,20
GREEDY,4269,17,2,4,23
STINGY,1789,2,0,3,5
STINGY,1497,4,1,2,7
STINGY,1754,1,0,0,1
GREEDY,5394,15,1,2,18
STINGY,420,3,0,1,4
GREEDY,2913,17,2,2,21
GREEDY,4731,17,1,2,20
STINGY,1272,3,0,0,3
GREEDY,3264,13,1,4,18
GREEDY,2779,13,0,3,16
STINGY,552,3,1,0,4
GREEDY,10709,15,1,4,20
STINGY,1183,4,0,0,4
GREEDY,3853,14,2,3,19
GREEDY,5682,17,2,2,21
STINGY,1092,3,0,1,4
GREEDY,4732,18,2,3,23
GREEDY,2582,17,2,4,23
GREEDY,3210,17,2,4,23
STINGY,1659,2,0,1,3
GREEDY,2781,17,1,3,21
STINGY,840,3,0,2,5
GREEDY,81,7,0,2,9
STINGY,2060,1,0,0,1
GREEDY,7083,16,1,2,19
STINGY,1792,1,0,1,2
STINGY,1780,2,0,0,2
GREEDY,3080,17,0,2,19
STINGY,1589,5,0,0,5
STINGY,1660,0,0,2,2
STINGY,1620,4,1,1,6
STINGY,1266,5,0,1,6
STINGY,1777,2,1,2,5
STINGY,1883,1,1,0,2
GREEDY,4515,14,2,4,20
GREEDY,8082,12,1,4,17
GREEDY,3331,18,1,3,22
STINGY,1862,6,0,1,7
STINGY,1176,2,0,0,2
GREEDY,1267,16,1,0,17
GREEDY,4063,18,1,2,21
GREEDY,4518,17,1,3,21
STINGY,2344,0,0,1,1
STINGY,1639,4,0,1,5
GREEDY,2767,12,2,4,18
STINGY,683,3,1,2,6
STINGY,1148,3,1,1,5
STINGY,715,8,0,0,8
STINGY,1196,6,0,2,8
GREEDY,3809,19,2,3,24
GREEDY,6180,15,1,2,18
GREEDY,4686,16,2,3,21
STINGY,1364,1,0,0,1
STINGY,1650,5,0,0,5
GREEDY,1099,11,2,4,17
STINGY,1761,4,0,1,5
GREEDY,2985,15,1,3,19
STINGY,1098,4,0,0,4
STINGY,1873,0,1,3,4
GREEDY,4100,18,2,2,22
GREEDY,6349,14,2,3,19
STINGY,1054,1,1,2,4
STINGY,980,4,1,0,5
STINGY,1280,4,1,0,5
GREEDY,8437,15,2,3,20
GREEDY,2495,18,0,4,22
GREEDY,3805,16,0,2,18
GREEDY,4304,15,2,1,18
STINGY,1789,1,0,0,1
GREEDY,1254,11,1,4,16
STINGY,1169,4,0,0,4
STINGY,924,4,0,0,4
GREEDY,4622,17,1,1,19
STINGY,1125,3,0,2,5
GREEDY,2279,12,1,2,15
GREEDY,4131,17,2,3,22
GREEDY,3256,16,2,3,21
GREEDY,9400,16,2,3,21
GREEDY,4216,16,1,4,21
GREEDY,2488,18,1,2,21
GREEDY,7998,16,1,3,20
GREEDY,1571,13,1,3,17
GREEDY,1127,22,1,4,27
STINGY,1500,1,1,1,3
GREEDY,4351,16,2,2,20
GREEDY,4587,16,2,3,21
STINGY,1116,5,0,0,5
GREEDY,1660,15,2,2,19
GREEDY,2692,16,2,3,21
STINGY,3045,3,1,0,4
GREEDY,2698,13,1,4,18
,,,,
GREEDY,6540,17,0,2,19
STINGY,868,6,0,0,6
STINGY,1787,1,0,0,1
GREEDY,2452,15,2,4,21
STINGY,1667,1,1,0,2
GREEDY,4391,18,2,3,23
STINGY,732,3,0,0,3
GREEDY,5875,15,1,3,19
GREEDY,4603,17,1,2,20
STINGY,1638,2,0,0,2
STINGY,1595,4,1,2,7
GREEDY,3718,18,2,3,23
STINGY,1387,2,0,1,3
GREEDY,4157,17,2,4,23
STINGY,963,4,0,0,4
GREEDY,1450,13,2,2,17
STINGY,1830,0,0,0,0
STINGY,1880,4,0,0,4
GREEDY,1392,18,1,3,22
STINGY,1932,5,0,4,9
GREEDY,6175,13,2,4,19
GREEDY,8695,14,1,3,18
STINGY,1323,3,1,0,4
STINGY,2124,2,0,0,2
GREEDY,2398,20,2,4,26
STINGY,2042,2,0,0,2
GREEDY,3304,13,1,3,17
GREEDY,6981,14,2,4,20
GREEDY,3466,15,2,4,21
GREEDY,10137,16,2,3,21
GREEDY,9909,15,1,4,20
STINGY,2175,3,0,0,3
GREEDY,1553,19,1,3,23
GREEDY,2158,15,2,3,20
STINGY,1252,5,1,2,8
GREEDY,8425,15,2,3,20
STINGY,1248,2,0,1,3
STINGY,1352,1,0,0,1
GREEDY,2207,17,2,4,23
GREEDY,3127,17,2,3,22
GREEDY,2420,17,2,4,23
STINGY,1579,3,0,0,3
STINGY,2384,1,1,2,4
STINGY,2148,3,1,0,4
GREEDY,2689,17,1,4,22
GREEDY,2325,16,2,4,22
STINGY,1928,1,0,1,2
GREEDY,6549,14,2,2,18
GREEDY,996,17,2,2,21
STINGY,1423,6,1,0,7
GREEDY,3266,18,2,4,24
GREEDY,2530,15,1,2,18
GREEDY,4717,15,2,3,20
STINGY,1814,0,0,0,0
GREEDY,4745,16,2,3,21
GREEDY,2159,18,2,3,23
GREEDY,6327,16,2,2,20
GREEDY,2385,17,2,4,23
STINGY,1287,4,1,2,7
STINGY,1313,2,0,0,2
GREEDY,5278,16,1,1,18
GREEDY,5108,14,2,2,18
STINGY,875,3,0,0,3
STINGY,529,3,1,2,6
STINGY,1531,3,0,1,4
GREEDY,2550,14,1,3,18
GREEDY,23087,12,2,2,16
STINGY,1810,2,0,0,2
GREEDY,2650,13,0,4,17
GREEDY,7285,16,1,3,20
GREEDY,3441,18,1,1,20
GREEDY,6689,16,1,4,21
STINGY,988,8,1,2,11
GREEDY,9064,13,1,3,17
STINGY,1135,1,0,1,2
GREEDY,2898,17,2,2,21
STINGY,1811,3,0,0,3
GREEDY,5643,18,2,2,22
STINGY,2168,2,0,0,2
STINGY,1675,6,0,0,6
GREEDY,2696,12,0,4,16
STINGY,1816,5,0,1,6
GREEDY,3579,15,2,4,21
GREEDY,6536,14,2,3,19
GREEDY,2647,15,2,3,20
GREEDY,4163,17,1,4,22
GREEDY,2223,15,2,3,20
STINGY,1415,2,0,2,4
,,,,
GREEDY,2090,17,2,4,23
GREEDY,3660,14,1,2,17
GREEDY,1577,16,2,2,20
STINGY,1491,2,0,0,2
STINGY,1283,3,1,0,4
STINGY,1887,4,1,0,5
GREEDY,3688,17,0,3,20
STINGY,1986,4,0,1,5
STINGY,1710,3,0,0,3
STINGY,336,6,1,1,8
GREEDY,3043,16,2,4,22
STINGY,1705,2,2,1,5
STINGY,2251,1,0,2,3
GREEDY,2389,18,1,2,21
GREEDY,1006,16,2,4,22
STINGY,1518,3,0,0,3
STINGY,1478,0,1,1,2
GREEDY,4066,16,2,4,22
STINGY,947,3,0,1,4
STINGY,1660,3,0,0,3
STINGY,2095,3,1,2,6
STINGY,1656,3,0,0,3
GREEDY,1750,19,1,3,23
GREEDY,1797,13,2,2,17
STINGY,2163,3,0,0,3
GREEDY,5724,16,0,4,20
GREEDY,3658,15,1,3,19
STINGY,1528,2,1,1,4
GREEDY,2798,16,2,3,21
GREEDY,9362,12,2,4,18
STINGY,1943,6,0,0,6
GREEDY,3403,17,1,4,22
STINGY,843,4,0,1,5
STINGY,1418,4,0,1,5
GREEDY,1749,18,1,3,22
STINGY,1200,4,0,0,4
STINGY,1692,4,0,0,4
GREEDY,1642,19,2,3,24
GREEDY,2228,15,1,2,18
STINGY,767,5,1,0,6
GREEDY,4628,17,0,3,20
GREEDY,3940,16,2,3,21
STINGY,2147,6,0,0,6
GREEDY,4410,17,2,2,21
GREEDY,9668,15,2,1,18
STINGY,1082,3,1,1,5
GREEDY,14628,16,1,3,20
GREEDY,6360,13,1,4,18
GREEDY,3784,16,2,2,20
STINGY,887,6,0,1,7
GREEDY,7473,16,2,3,21
GREEDY,5501,14,2,3,19
GREEDY,2564,16,2,2,20
,,,,
GREEDY,4193,14,2,3,19
STINGY,1551,2,0,2,4
GREEDY,2123,16,1,2,19
STINGY,1776,1,0,0,1
GREEDY,5956,16,1,1,18
STINGY,1408,4,1,0,5
STINGY,1128,3,1,1,5
STINGY,1085,4,0,2,6
STINGY,1356,2,0,0,2
GREEDY,3997,15,1,4,20
GREEDY,5852,17,2,3,22
GREEDY,2826,16,1,4,21
STINGY,1862,3,0,0,3
GREEDY,5172,17,0,3,20
GREEDY,4681,16,1,3,20
GREEDY,1131,12,1,4,17
STINGY,1810,1,0,0,1
GREEDY,6064,12,1,4,17
STINGY,1501,5,1,1,7
STINGY,754,1,1,0,2
GREEDY,2981,13,1,4,18
STINGY,862,6,0,0,6
STINGY,1804,5,0,1,6
STINGY,1384,3,0,3,6
GREEDY,2839,13,2,3,18
STINGY,1164,2,1,0,3
STINGY,1243,4,1,2,7
GREEDY,5807,15,1,3,19
GREEDY,2269,16,1,2,19
GREEDY,3042,17,1,3,21
STINGY,1964,1,0,0,1
GREEDY,3002,18,2,4,24
GREEDY,3726,14,2,3,19
STINGY,1303,3,0,0,3
STINGY,2255,3,0,0,3
GREEDY,2881,16,2,4,22
STINGY,1176,3,0,1,4
STINGY,1115,2,0,0,2
GREEDY,4654,13,1,2,16
GREEDY,6579,16,1,1,18
GREEDY,2881,18,2,3,23
STINGY,495,6,0,2,8
GREEDY,4211,17,1,3,21
GREEDY,3343,15,2,3,20
GREEDY,3593,18,1,2,21
GREEDY,5261,15,1,3,19
GREEDY,2751,18,1,3,22
STINGY,1189,4,0,0,4
STINGY,673,6,0,2,8
GREEDY,1360,18,1,4,23
STINGY,1649,2,0,0,2
STINGY,721,5,0,1,6
STINGY,1038,2,0,0,2
GREEDY,3527,19,1,2,22
GREEDY,3243,16,1,3,20
STINGY,1892,1,0,1,2
GREEDY,4138,16,1,3,20
STINGY,1702,0,0,0,0
GREEDY,12655,14,2,2,18
STINGY,1738,2,0,0,2
STINGY,1578,0,0,0,0
GREEDY,1494,16,0,4,20
STINGY,1408,7,0,0,7
GREEDY,4373,19,0,3,22
STINGY,541,6,1,1,8
STINGY,903,2,0,1,3
GREEDY,7745,15,2,2,19
GREEDY,5309,14,2,3,19
STINGY,1864,2,0,1,3
STINGY,1440,1,0,0,1
GREEDY,3655,20,2,3,25
STINGY,1258,2,0,0,2
GREEDY,3221,15,2,4,21
GREEDY,2949,14,1,4,19
STINGY,787,3,2,0,5
STINGY,886,2,0,1,3
STINGY,1999,3,1,2,6
GREEDY,2022,18,0,2,20
GREEDY,3365,15,1,4,20
GREEDY,1806,13,2,4,19
STINGY,920,2,0,1,3
STINGY,1635,2,1,0,3
GREEDY,2406,13,1,4,18
STINGY,1826,1,1,0,2
GREEDY,3112,18,2,1,21
STINGY,1235,3,0,2,5
STINGY,1048,1,1,3,5
GREEDY,3480,17,2,3,22
STINGY,934,3,0,0,3
STINGY,2115,4,1,3,8
GREEDY,2427,17,2,3,22
GREEDY,687,14,1,4,19
GREEDY,2175,18,1,3,22
STINGY,748,8,0,0,8
GREEDY,5191,14,2,2,18
GREEDY,2907,18,2,3,23
GREEDY,2895,15,1,4,20
GREEDY,19066,15,2,2,19
GREEDY,5394,12,2,4,18
STINGY,905,4,2,0,6
GREEDY,3939,17,1,3,21
GREEDY,6491,17,1,3,21
GREEDY,4629,16,2,3,21
GREEDY,3282,15,1,2,18
STINGY,844,2,0,0,2
STINGY,1616,3,0,0,3
GREEDY,4439,16,1,4,21
STINGY,2199,2,1,1,4
GREEDY,2690,18,1,1,20
GREEDY,5208,13,2,3,18
STINGY,1063,4,0,0,4
STINGY,1222,4,0,1,5
GREEDY,4037,20,1,3,24
GREEDY,2136,20,2,4,26
GREEDY,1539,16,1,3,20
STINGY,1380,3,0,0,3
GREEDY,7908,14,2,3,19
GREEDY,3548,11,2,4,17
STINGY,1010,5,1,1,7
GREEDY,6346,13,0,2,15
GREEDY,1326,20,1,3,24
GREEDY,3730,15,2,4,21
GREEDY,2994,14,1,4,19
GREEDY,4469,17,2,4,23
GREEDY,2656,14,2,4,20
GREEDY,3800,17,1,2,20
STINGY,1795,2,0,1,3
GREEDY,2356,16,1,3,20
STINGY,1796,1,0,0,1
STINGY,1648,1,0,1,2
GREEDY,3028,15,2,3,20
STINGY,778,3,1,1,5
GREEDY,6733,13,2,2,17
GREEDY,2856,16,2,3,21
STINGY,2244,5,0,1,6
GREEDY,7048,14,2,2,18
GREEDY,4230,19,1,4,24
GREEDY,10727,15,2,3,20
GREEDY,2024,13,1,4,18
GREEDY,6210,16,2,2,20
GREEDY,5838,15,2,2,19
GREEDY,7057,15,1,4,20
STINGY,1852,2,0,0,2
GREEDY,2399,14,1,3,18
STINGY,1859,2,0,0,2
GREEDY,4046,18,2,4,24
STINGY,1181,7,0,1,8
STINGY,1381,1,0,1,2
GREEDY,2207,19,1,1,21
GREEDY,2698,15,2,4,21
STINGY,1559,6,0,2,8
STINGY,1719,0,0,0,0
STINGY,1538,2,0,0,2
GREEDY,3586,17,2,3,22
GREEDY,1959,15,0,2,17
GREEDY,3428,16,2,3,21
STINGY,1670,3,0,0,3
GREEDY,3431,16,2,3,21
GREEDY,3599,14,1,4,19
GREEDY,6980,14,2,3,19
GREEDY,1964,16,1,4,21
GREEDY,1483,13,0,2,15
STINGY,1578,5,0,1,6
STINGY,1320,4,0,0,4
GREEDY,4327,17,1,3,21
GREEDY,1051,9,2,3,14
GREEDY,3865,17,2,3,22
GREEDY,4341,17,1,4,22
GREEDY,447,7,1,3,11
GREEDY,1470,15,1,4,20
GREEDY,5458,16,1,4,21
GREEDY,1871,10,2,3,15
STINGY,2285,3,0,0,3
STINGY,1125,3,0,0,3
STINGY,1524,0,1,0,1
GREEDY,1293,12,2,4,18
GREEDY,3508,16,1,2,19
GREEDY,3300,16,2,2,20
GREEDY,3973,20,2,3,25
GREEDY,1906,16,1,3,20
STINGY,1272,1,0,1,2
GREEDY,836,14,2,2,18
STINGY,1613,3,0,1,4
STINGY,1391,6,0,1,7
GREEDY,4681,17,2,2,21
,,,,
GREEDY,5119,17,1,2,20
GREEDY,4183,18,1,2,21
GREEDY,2361,15,2,4,21
STINGY,1561,2,0,1,3
GREEDY,4033,16,0,4,20
GREEDY,3166,12,2,4,18
GREEDY,731,15,1,3,19
GREEDY,1238,11,1,0,12
STINGY,1731,3,0,0,3
GREEDY,2263,14,1,2,17
GREEDY,3979,17,2,3,22
STINGY,1313,4,0,0,4
STINGY,2078,0,1,0,1
GREEDY,1905,12,1,4,17
GREEDY,2270,16,2,2,20
STINGY,985,8,0,1,9
GREEDY,2314,13,1,2,16
GREEDY,3600,14,1,3,18
STINGY,587,7,0,1,8
STINGY,1909,0,0,1,1
STINGY,1203,3,0,1,4
STINGY,589,3,0,1,4
GREEDY,2862,15,0,3,18
GREEDY,3537,18,1,3,22
GREEDY,2785,15,1,2,18
GREEDY,7068,17,2,1,20
GREEDY,3303,16,2,4,22
GREEDY,17158,14,1,3,18
STINGY,1659,0,1,1,2
STINGY,1267,3,0,1,4
GREEDY,3043,13,2,3,18
STINGY,1512,2,1,0,3
GREEDY,4648,16,2,4,22
STINGY,1728,3,0,1,4
GREEDY,6604,15,2,3,20
STINGY,1051,2,0,1,3
GREEDY,2912,16,1,2,19
GREEDY,2396,20,2,3,25
GREEDY,4752,13,1,2,16
GREEDY,1197,13,2,4,19
GREEDY,5210,18,1,3,22
GREEDY,3844,17,2,4,23
GREEDY,3078,18,1,4,23
STINGY,2239,3,0,2,5
STINGY,1659,1,1,0,2
STINGY,980,2,1,1,4
STINGY,2375,5,2,2,9
GREEDY,6135,14,2,2,18
STINGY,1716,8,1,2,11
GREEDY,3163,14,2,3,19
STINGY,1756,2,0,0,2
GREEDY,8410,13,1,3,17
STINGY,1208,6,1,0,7
STINGY,1351,2,0,0,2
GREEDY,2485,17,2,4,23
GREEDY,11855,17,2,3,22
GREEDY,2316,10,1,4,15
GREEDY,7595,15,2,1,18
STINGY,1461,6,0,1,7
STINGY,1361,3,0,1,4
STINGY,1704,1,0,0,1
GREEDY,1177,12,1,1,14
STINGY,2816,5,0,0,5
STINGY,1879,5,0,2,7
STINGY,1326,3,1,2,6
STINGY,1238,2,1,0,3
GREEDY,5390,15,1,3,19
GREEDY,900,13,0,4,17
STINGY,1481,2,0,0,2
GREEDY,6900,15,1,4,20
STINGY,1779,3,1,2,6
GREEDY,2524,17,2,2,21
STINGY,2242,4,0,0,4
GREEDY,4656,17,2,3,22
GREEDY,8766,12,1,3,16
STINGY,2693,5,0,1,6
GREEDY,3786,16,1,4,21
GREEDY,3931,18,2,1,21
GREEDY,7318,17,1,3,21
GREEDY,3198,18,2,3,23
STINGY,717,3,1,1,5
STINGY,1316,3,0,1,4
STINGY,1228,4,0,1,5
GREEDY,4899,17,2,2,21
GREEDY,4387,13,2,3,18
GREEDY,9476,15,2,3,20
GREEDY,1156,9,2,4,15
STINGY,1811,4,0,3,7
STINGY,1526,1,1,1,3
STINGY,1050,2,0,0,2
STINGY,1758,5,0,0,5
GREEDY,2155,14,1,3,18
GREEDY,2647,18,2,1,21
GREEDY,2189,13,2,3,18
GREEDY,3522,14,2,4,20
STINGY,1453,3,0,0,3
GREEDY,3279,17,2,4,23
GREEDY,10962,16,2,3,21
GREEDY,4330,15,1,3,19
GREEDY,3558,16,1,3,20
STINGY,1147,3,1,2,6
GREEDY,5901,16,1,3,20
GREEDY,4467,16,2,4,22
STINGY,2156,4,0,1,5
GREEDY,3969,17,1,4,22
GREEDY,3392,15,2,3,20
STINGY,2051,1,0,0,1
GREEDY,748,19,2,4,25
STINGY,905,4,1,0,5
GREEDY,5189,14,1,4,19
STINGY,1164,5,0,3,8
GREEDY,2739,15,1,3,19
STINGY,609,5,0,2,7
GREEDY,9387,16,0,3,19
GREEDY,10926,14,1,4,19
STINGY,1515,5,0,2,7
GREEDY,293,6,1,2,9
STINGY,1364,3,1,1,5
STINGY,1353,5,0,1,6
GREEDY,4147,15,2,4,21
STINGY,1442,5,0,0,5
GREEDY,5115,17,2,2,21
GREEDY,17451,13,2,1,16
STINGY,1500,3,0,1,4
STINGY,1859,2,0,0,2
GREEDY,3162,16,0,3,19
STINGY,1290,1,0,3,4
GREEDY,6921,14,2,4,20
GREEDY,646,10,1,3,14
GREEDY,4306,16,1,2,19
STINGY,1527,4,0,1,5
STINGY,1211,4,0,0,4
STINGY,1130,4,0,1,5
GREEDY,4088,16,1,4,21
GREEDY,8542,13,2,4,19
,,,,
GREEDY,3415,15,2,3,20
GREEDY,2783,16,2,3,21
GREEDY,1299,17,1,3,21
STINGY,1923,2,0,1,3
STINGY,1566,4,1,0,5
GREEDY,2460,16,2,3,21
GREEDY,1615,15,1,3,19
GREEDY,3092,17,0,3,20
STINGY,2450,2,0,1,3
STINGY,56160,11,0,2,13
GREEDY,3444,16,1,3,20
STINGY,1588,3,0,0,3
STINGY,790,3,0,1,4
STINGY,950,6,1,0,7
STINGY,2490,2,0,0,2
STINGY,1365,2,1,1,4
STINGY,1301,2,0,1,3
GREEDY,3224,18,2,3,23
STINGY,1408,1,1,2,4
GREEDY,4789,16,2,1,19
STINGY,1200,3,1,0,4
STINGY,824,5,2,1,8
GREEDY,4437,18,2,4,24
GREEDY,4524,15,2,4,21
STINGY,1398,4,0,1,5
STINGY,1426,1,1,0,2
GREEDY,2925,15,1,3,19
GREEDY,8012,15,0,4,19
GREEDY,2400,12,1,4,17
GREEDY,2997,15,2,4,21
GREEDY,3593,15,2,3,20
STINGY,1818,2,1,0,3
GREEDY,2690,17,1,3,21
GREEDY,3478,17,2,3,22
STINGY,977,4,0,2,6
GREEDY,6134,17,2,2,21
GREEDY,3127,16,2,3,21
STINGY,1270,2,0,2,4
GREEDY,2919,17,2,3,22
GREEDY,2053,17,2,4,23
STINGY,1669,2,0,0,2
GREEDY,2051,15,0,2,17
STINGY,722,4,0,1,5
GREEDY,1861,17,2,1,20
GREEDY,4625,17,2,1,20
STINGY,1112,1,0,2,3
STINGY,1181,4,0,1,5
GREEDY,8377,16,2,4,22
GREEDY,1982,16,2,3,21
GREEDY,1190,18,2,4,24
STINGY,1521,2,0,0,2
GREEDY,2776,14,1,2,17
STINGY,1817,4,0,1,5
GREEDY,11121,15,2,2,19
GREEDY,4369,17,2,3,22
STINGY,2141,2,0,1,3
STINGY,1380,1,0,1,2
GREEDY,11556,13,2,3,18
STINGY,1412,2,0,0,2
GREEDY,7612,15,2,2,19
STINGY,1874,0,0,1,1
STINGY,1542,2,0,0,2
STINGY,1841,3,1,1,5
STINGY,902,4,1,0,5
STINGY,2955,4,0,0,4
STINGY,1595,2,0,0,2
GREEDY,8700,13,2,3,18
GREEDY,3528,16,2,4,22
GREEDY,2050,15,2,3,20
GREEDY,4109,13,2,4,19
STINGY,732,4,0,2,6
GREEDY,1940,16,1,4,21
GREEDY,2592,19,2,3,24
GREEDY,1888,15,2,3,20
STINGY,1385,2,0,0,2
GREEDY,1151,12,2,4,18
GREEDY,4063,18,1,2,21
GREEDY,12679,15,1,3,19
STINGY,1618,2,0,0,2
STINGY,1208,1,1,1,3
STINGY,2518,4,0,1,5
STINGY,1390,3,0,0,3
STINGY,1355,2,0,1,3
GREEDY,6084,16,2,2,20
STINGY,909,7,0,2,9
GREEDY,15102,16,1,3,20
STINGY,2351,2,0,0,2
GREEDY,3998,17,2,4,23
STINGY,1011,6,0,1,7
STINGY,1065,3,1,0,4
GREEDY,3031,16,2,3,21
STINGY,1519,1,1,0,2
STINGY,936,2,0,1,3
GREEDY,1929,17,1,3,21
GREEDY,4827,16,1,3,20
STINGY,1608,2,0,1,3
GREEDY,5835,13,0,4,17
GREEDY,4194,17,2,4,23
GREEDY,1572,16,2,3,21
STINGY,1136,5,0,1,6
GREEDY,1198,13,2,4,19
STINGY,2253,0,0,0,0
STINGY,1061,3,0,0,3
GREEDY,4114,15,1,3,19
GREEDY,6381,13,2,3,18
GREEDY,7322,15,2,3,20
STINGY,2195,1,0,1,2
STINGY,1318,3,0,1,4
GREEDY,2133,18,1,3,22
STINGY,1990,2,0,1,3
STINGY,1993,2,0,1,3
GREEDY,1950,16,1,4,21
GREEDY,5268,16,2,2,20
GREEDY,5615,15,1,4,20
STINGY,2081,3,1,0,4
STINGY,1393,3,0,0,3
STINGY,1264,2,0,0,2
STINGY,1340,2,0,1,3
STINGY,1954,2,1,1,4
GREEDY,3037,15,2,2,19
STINGY,1396,2,0,0,2
STINGY,1830,1,0,0,1
STINGY,1727,1,0,0,1
STINGY,1473,2,0,1,3
GREEDY,6480,15,1,3,19
GREEDY,4945,17,2,3,22
STINGY,1979,2,1,0,3
STINGY,771,7,0,1,8
GREEDY,2011,15,2,3,20
GREEDY,5894,17,1,4,22
STINGY,1115,3,0,1,4
STINGY,1854,1,1,0,2
GREEDY,4505,16,1,3,20
GREEDY,8170,14,2,3,19
GREEDY,3953,17,2,3,22
GREEDY,1082,15,2,4,21
GREEDY,3275,16,2,2,20
GREEDY,4804,15,1,2,18
STINGY,1036,3,1,2,6
STINGY,822,4,0,0,4
STINGY,1635,3,1,1,5
STINGY,1986,2,0,2,4
GREEDY,5100,16,1,3,20
GREEDY,2628,20,1,4,25
GREEDY,2815,13,1,4,18
GREEDY,11683,16,2,4,22
GREEDY,1009,15,2,4,21
STINGY,1001,4,0,2,6
GREEDY,1221,13,1,4,18
STINGY,1389,2,0,0,2
STINGY,401,3,1,2,6
GREEDY,3426,17,2,3,22
GREEDY,2919,16,2,3,21
STINGY,1706,2,0,1,3
STINGY,1982,5,1,1,7
STINGY,1702,2,0,0,2
GREEDY,5345,16,2,4,22
STINGY,1828,2,0,0,2
GREEDY,3268,16,2,2,20
GREEDY,4283,13,2,3,18
GREEDY,2403,18,1,3,22
STINGY,1347,2,1,1,4
STINGY,1208,5,0,1,6
GREEDY,2655,13,2,3,18
GREEDY,1849,14,2,2,18
STINGY,1548,0,0,1,1
GREEDY,4194,16,2,1,19
STINGY,1212,2,0,1,3
STINGY,1255,5,0,0,5
GREEDY,4894,14,2,3,19
GREEDY,1272,13,2,3,18
GREEDY,9031,15,1,4,20
GREEDY,4761,14,2,4,20
GREEDY,6991,18,1,2,21
GREEDY,7664,15,1,3,19
STINGY,805,5,0,2,7
GREEDY,1948,16,2,3,21
STINGY,1749,0,0,0,0
STINGY,1433,2,0,1,3
GREEDY,7753,13,2,4,19
,,,,
GREEDY,1663,14,1,4,19
GREEDY,606,15,1,3,19
GREEDY,2066,17,2,3,22
GREEDY,3069,17,2,2,21
STINGY,1147,6,2,0,8
STINGY,1464,2,0,0,2
GREEDY,1372,15,2,4,21
STINGY,1614,2,0,0,2
GREEDY,2058,15,2,2,19
STINGY,1029,2,0,1,3
GREEDY,4261,17,2,3,22
GREEDY,2403,14,2,2,18
STINGY,1516,3,0,0,3
GREEDY,3175,19,2,2,23
GREEDY,2986,18,2,3,23
GREEDY,2886,19,2,3,24
GREEDY,1758,15,2,3,20
,,,,
GREEDY,3126,18,1,3,22
STINGY,1577,4,0,2,6
STINGY,2520,3,0,0,3
STINGY,1466,3,0,0,3
STINGY,1108,4,0,0,4
GREEDY,12998,14,2,3,19
GREEDY,2859,16,2,3,21
GREEDY,590,10,1,2,13
GREEDY,8871,15,2,2,19
GREEDY,2776,16,1,3,20
STINGY,2109,3,1,0,4
GREEDY,2287,14,2,3,19
GREEDY,4696,16,1,3,20
GREEDY,1365,15,2,3,20
STINGY,1418,2,0,0,2
GREEDY,892,20,1,3,24
GREEDY,4748,19,1,4,24
GREEDY,4819,18,1,2,21
GREEDY,5650,18,2,3,23
GREEDY,3556,14,1,4,19
STINGY,1425,3,0,1,4
STINGY,69818,9,1,2,12
GREEDY,2575,18,1,3,22
GREEDY,2214,17,1,3,21
STINGY,2312,2,0,1,3
STINGY,812,3,0,1,4
STINGY,1409,4,1,0,5
GREEDY,4213,14,2,4,20
GREEDY,2007,18,2,3,23
GREEDY,847,15,2,3,20
STINGY,1196,2,0,0,2
GREEDY,9412,14,2,2,18
STINGY,1870,2,1,0,3
STINGY,818,5,0,1,6
GREEDY,4642,15,2,3,20
GREEDY,3481,16,2,4,22
GREEDY,2208,16,1,4,21
GREEDY,4880,16,1,3,20
GREEDY,4083,17,1,4,22
GREEDY,6899,17,1,2,20
STINGY,772,9,0,0,9
STINGY,1686,3,0,0,3
GREEDY,3663,18,2,2,22
GREEDY,3769,16,2,4,22
STINGY,1726,3,1,0,4
STINGY,1532,2,0,0,2
STINGY,1657,6,2,0,8
GREEDY,731,8,0,2,10
STINGY,2550,2,0,2,4
STINGY,1710,0,0,0,0
GREEDY,12503,14,1,2,17
GREEDY,1334,16,2,2,20
STINGY,813,6,0,0,6
GREEDY,2038,18,1,2,21
GREEDY,4852,14,2,3,19
STINGY,1409,5,2,0,7
GREEDY,1929,11,1,2,14
GREEDY,2016,17,1,1,19
GREEDY,3032,17,2,4,23
STINGY,1379,1,1,1,3
GREEDY,1924,15,1,4,20
GREEDY,4144,15,2,4,21
STINGY,1442,1,0,0,1
GREEDY,2598,17,2,3,22
GREEDY,5393,16,1,3,20
GREEDY,3216,15,1,4,20
GREEDY,4478,16,1,4,21
GREEDY,4720,16,2,4,22
GREEDY,1447,17,2,4,23
STINGY,1659,1,0,0,1
GREEDY,1060,14,1,1,16
GREEDY,3273,18,2,2,22
STINGY,1326,2,1,0,3
GREEDY,7322,14,2,3,19
GREEDY,2365,17,2,4,23
GREEDY,2283,19,2,3,24
GREEDY,4405,18,0,4,22
GREEDY,3970,15,2,2,19
GREEDY,7487,14,2,2,18
GREEDY,2353,17,1,3,21
GREEDY,1925,14,0,3,17
STINGY,1940,3,1,0,4
GREEDY,3104,16,2,4,22
STINGY,1108,4,0,3,7
GREEDY,5520,18,2,3,23
GREEDY,4925,15,2,4,21
GREEDY,909,13,1,1,15
GREEDY,2623,14,1,2,17
GREEDY,6092,16,1,3,20
GREEDY,3665,13,2,4,19
GREEDY,5724,17,2,3,22
STINGY,1606,0,1,0,1
GREEDY,2435,17,0,3,20
GREEDY,2682,16,1,3,20
STINGY,1336,2,0,1,3
STINGY,1615,4,0,0,4
GREEDY,3500,14,2,3,19
GREEDY,3058,16,2,3,21
GREEDY,20823,14,2,4,20
GREEDY,8617,15,2,4,21
GREEDY,2079,15,0,3,18
GREEDY,4030,17,2,4,23
GREEDY,2034,19,2,2,23
GREEDY,4739,17,1,2,20
STINGY,1546,3,0,0,3
STINGY,1450,1,0,0,1
GREEDY,2111,15,2,4,21
GREEDY,2781,17,2,3,22
GREEDY,5371,18,1,3,22
GREEDY,7451,17,1,3,21
GREEDY,7460,17,1,2,20
GREEDY,1814,13,0,2,15
GREEDY,7192,16,1,2,19
STINGY,1644,2,0,1,3
STINGY,201,4,0,0,4
STINGY,1457,3,1,2,6
STINGY,1708,4,1,0,5
STINGY,2073,0,0,1,1
GREEDY,9465,13,0,2,15
STINGY,773,4,0,2,6
GREEDY,3625,17,1,3,21
STINGY,1709,1,0,1,2
GREEDY,1887,16,2,2,20
STINGY,1822,3,1,1,5
STINGY,917,3,0,1,4
STINGY,1907,2,0,0,2
GREEDY,3671,14,1,3,18
GREEDY,1509,12,0,3,15
STINGY,1567,1,0,0,1
GREEDY,2132,19,2,3,24
STINGY,1558,0,0,0,0
STINGY,1466,2,0,0,2
GREEDY,5470,16,1,4,21
GREEDY,3082,16,2,2,20
STINGY,1742,1,0,1,2
GREEDY,1083,17,0,3,20
STINGY,2204,2,0,1,3
STINGY,2419,3,0,0,3
GREEDY,3699,16,1,4,21
GREEDY,822,16,1,4,21
GREEDY,6201,16,2,3,21
GREEDY,3793,14,2,4,20
GREEDY,12226,17,2,2,21
GREEDY,2952,17,2,4,23
GREEDY,4908,13,0,3,16
STINGY,1229,1,1,0,2
GREEDY,3350,16,2,4,22
GREEDY,16072,13,2,4,19
GREEDY,7020,15,0,2,17
GREEDY,6259,16,1,3,20
STINGY,1665,2,0,0,2
STINGY,2077,3,1,0,4
STINGY,2578,3,0,3,6
GREEDY,3233,16,2,3,21
STINGY,1942,6,0,0,6
STINGY,1461,1,1,2,4
GREEDY,3009,16,1,3,20
GREEDY,7913,17,2,2,21
GREEDY,4154,15,2,3,20
STINGY,1447,2,1,0,3
STINGY,1196,1,0,0,1
GREEDY,3285,16,2,4,22
GREEDY,5510,16,2,3,21
STINGY,1485,2,0,2,4
STINGY,1909,1,0,0,1
STINGY,1384,4,1,1,6
GREEDY,3972,17,2,3,22
STINGY,1343,2,0,0,2
STINGY,2238,1,0,0,1
STINGY,2351,3,0,0,3
STINGY,1389,2,0,0,2
STINGY,1794,2,0,1,3
STINGY,1342,4,0,3,7
GREEDY,3262,19,0,4,23
GREEDY,1325,19,0,3,22
