strategy,money,countries,utilities,stations,totalLandsOwned
STINGY,1674,2,1,1,4
GREEDY,2528,14,1,4,19
GREEDY,447,10,0,4,14
GREEDY,2956,15,2,3,20
STINGY,758,4,0,1,5
STINGY,25469,9,1,1,11
GREEDY,2365,15,1,4,20
GREEDY,2720,17,2,3,22
GREEDY,2386,14,0,4,18
STINGY,1150,3,0,0,3
GREEDY,3647,16,2,3,21
STINGY,2706,5,0,3,8
STINGY,1303,1,1,3,5
STINGY,1597,3,0,1,4
GREEDY,6242,15,2,3,20
STINGY,2027,1,0,2,3
STINGY,1806,6,0,1,7
STINGY,1526,2,0,0,2
GREEDY,5301,17,1,3,21
STINGY,1943,1,1,1,3
STINGY,1522,1,1,0,2
GREEDY,5212,14,1,4,19
GREEDY,5425,17,2,4,23
GREEDY,936,14,1,4,19
STINGY,1488,5,0,0,5
GREEDY,4696,15,2,2,19
STINGY,2563,2,1,1,4
STINGY,1192,4,0,1,5
GREEDY,1640,18,2,2,22
STINGY,1510,3,0,0,3
STINGY,2218,2,0,1,3
STINGY,3100,3,0,2,5
GREEDY,6404,14,1,3,18
GREEDY,3089,16,1,4,21
GREEDY,3764,16,2,4,22
STINGY,1246,2,0,0,2
GREEDY,7692,16,1,2,19
STINGY,1241,2,0,0,2
STINGY,1302,3,0,0,3
GREEDY,4794,16,1,3,20
STINGY,1987,1,1,0,2
GREEDY,96310,16,2,1,19
GREEDY,5536,15,2,4,21
GREEDY,6384,16,1,3,20
STINGY,1597,3,0,0,3
STINGY,1582,6,0,0,6
STINGY,1071,4,0,0,4
STINGY,1295,3,0,0,3
STINGY,1362,2,0,0,2
STINGY,1436,4,0,0,4
GREEDY,3569,17,1,3,21
STINGY,2008,3,0,2,5
STINGY,1910,3,0,0,3
GREEDY,3298,12,1,3,16
GREEDY,8182,17,1,3,21
STINGY,1936,1,0,1,2
GREEDY,5349,17,2,4,23
GREEDY,4701,14,2,3,19
GREEDY,4039,16,1,3,20
GREEDY,3422,15,2,3,20
GREEDY,1636,17,1,3,21
GREEDY,5243,18,2,2,22
GREEDY,2937,14,2,2,18
GREEDY,3439,14,2,4,20
GREEDY,3541,17,2,3,22
GREEDY,2426,16,2,4,22
STINGY,1012,3,0,1,4
GREEDY,1968,10,2,4,16
STINGY,2398,5,0,3,8
GREEDY,2955,16,2,3,21
GREEDY,4195,18,1,4,23
GREEDY,7940,13,2,3,18
STINGY,930,4,1,1,6
GREEDY,4185,17,0,3,20
GREEDY,2681,16,2,3,21
GREEDY,3993,17,2,3,22
GREEDY,2482,15,0,4,19
STINGY,1152,1,0,1,2
STINGY,1498,4,1,1,6
GREEDY,3093,16,0,3,19
GREEDY,3281,15,2,1,18
STINGY,1260,4,0,0,4
GREEDY,4432,16,1,4,21
GREEDY,3889,17,2,4,23
STINGY,1570,3,1,1,5
STINGY,1991,1,0,0,1
STINGY,1685,4,0,1,5
STINGY,1632,1,0,1,2
STINGY,1610,7,1,1,9
STINGY,1606,5,0,0,5
GREEDY,3216,16,1,2,19
GREEDY,223,12,2,4,18
GREEDY,2922,16,2,3,21
GREEDY,912,11,1,4,16
GREEDY,4318,17,1,4,22
STINGY,1615,1,1,0,2
STINGY,1038,4,0,1,5
GREEDY,1069,12,2,4,18
STINGY,2834,0,0,0,0
STINGY,256,5,1,0,6
STINGY,1436,2,2,1,5
STINGY,1172,3,1,2,6
STINGY,1931,2,0,1,3
STINGY,1478,6,0,1,7
GREEDY,4476,18,2,2,22
STINGY,1694,0,0,0,0
STINGY,1197,1,0,2,3
GREEDY,1297,18,2,2,22
GREEDY,3230,12,1,4,17
GREEDY,10863,16,1,3,20
GREEDY,1579,20,2,2,24
STINGY,1309,1,0,0,1
GREEDY,1571,13,1,3,17
GREEDY,5639,14,2,2,18
STINGY,1133,3,0,1,4
STINGY,2003,0,0,2,2
GREEDY,7532,13,2,4,19
GREEDY,3074,16,2,2,20
GREEDY,2028,15,2,4,21
GREEDY,4512,18,1,2,21
GREEDY,2504,16,1,4,21
STINGY,1522,3,0,0,3
GREEDY,11016,13,2,4,19
STINGY,1407,1,0,1,2
STINGY,1779,3,0,0,3
GREEDY,8119,14,1,1,16
GREEDY,7153,12,2,3,17
GREEDY,1913,17,2,3,22
GREEDY,3258,13,2,3,18
GREEDY,3347,16,0,3,19
STINGY,940,6,0,1,7
GREEDY,14208,15,0,2,17
GREEDY,7382,15,1,3,19
GREEDY,3489,18,1,4,23
STINGY,1850,2,1,0,3
STINGY,1853,1,0,0,1
STINGY,820,4,0,0,4
STINGY,2727,3,1,0,4
GREEDY,4961,13,2,3,18
GREEDY,2525,13,2,3,18
GREEDY,2586,15,1,4,20
STINGY,1167,6,0,0,6
GREEDY,2449,17,1,4,22
STINGY,1023,3,0,1,4
STINGY,1641,4,0,1,5
STINGY,977,3,0,2,5
STINGY,1234,7,0,1,8
GREEDY,4337,16,2,4,22
STINGY,2800,4,1,1,6
STINGY,1705,2,1,2,5
GREEDY,3197,18,0,2,20
GREEDY,5429,16,2,4,22
GREEDY,3161,15,2,3,20
GREEDY,574,11,2,2,15
GREEDY,3275,14,1,3,18
GREEDY,6143,16,1,2,19
STINGY,1007,6,1,0,7
GREEDY,3476,15,2,4,21
GREEDY,2442,14,1,3,18
GREEDY,3085,16,2,3,21
STINGY,982,4,1,1,6
GREEDY,6582,15,1,4,20
STINGY,1777,4,0,0,4
STINGY,1253,3,0,0,3
GREEDY,3572,16,1,3,20
GREEDY,1446,17,2,2,21
STINGY,1667,1,0,0,1
STINGY,935,3,0,1,4
GREEDY,2935,15,1,2,18
GREEDY,3824,15,2,2,19
STINGY,2119,4,0,0,4
STINGY,1670,2,0,0,2
STINGY,2410,2,0,0,2
GREEDY,3402,17,1,3,21
GREEDY,2863,18,1,3,22
GREEDY,4694,15,2,2,19
GREEDY,3908,15,2,2,19
STINGY,1151,2,0,0,2
GREEDY,3332,18,2,3,23
STINGY,2119,5,0,0,5
GREEDY,1583,15,2,2,19
GREEDY,1899,17,1,4,22
GREEDY,8118,15,2,2,19
GREEDY,4643,18,1,2,21
STINGY,1624,1,1,0,2
GREEDY,3698,17,1,3,21
GREEDY,2152,15,1,2,18
GREEDY,540,13,1,3,17
GREEDY,2145,11,1,4,16
STINGY,1658,2,0,1,3
GREEDY,6806,18,2,1,21
STINGY,1984,0,0,1,1
STINGY,1891,6,0,0,6
STINGY,2093,2,0,0,2
GREEDY,2138,16,2,4,22
STINGY,1513,1,2,0,3
GREEDY,8906,15,2,1,18
STINGY,1718,0,1,0,1
STINGY,2180,4,0,0,4
GREEDY,3675,14,1,4,19
GREEDY,8344,17,1,2,20
STINGY,1218,2,0,0,2
GREEDY,5528,20,1,1,22
GREEDY,2730,17,2,3,22
GREEDY,3651,14,2,3,19
STINGY,1537,1,0,2,3
STINGY,1016,4,0,0,4
GREEDY,2916,18,2,4,24
STINGY,997,5,0,2,7
GREEDY,7241,14,2,3,19
GREEDY,2917,17,2,3,22
STINGY,1463,0,0,1,1
GREEDY,4457,15,1,3,19
GREEDY,1063,10,0,4,14
STINGY,717,4,0,1,5
GREEDY,3520,17,2,3,22
GREEDY,4643,18,2,3,23
STINGY,1061,4,0,1,5
STINGY,1117,5,0,0,5
GREEDY,1688,15,1,3,19
STINGY,371,4,0,2,6
GREEDY,3404,15,1,2,18
STINGY,1373,3,1,2,6
GREEDY,4192,17,2,3,22
GREEDY,3740,15,1,2,18
GREEDY,6077,16,2,3,21
GREEDY,4234,18,1,3,22
STINGY,1640,1,1,0,2
STINGY,1033,2,0,2,4
STINGY,1315,3,0,0,3
STINGY,1051,4,0,0,4
STINGY,2227,2,2,1,5
GREEDY,4143,13,2,3,18
GREEDY,2225,20,1,3,24
GREEDY,5046,18,1,2,21
GREEDY,2425,14,1,3,18
GREEDY,3433,19,2,2,23
STINGY,2088,1,0,0,1
GREEDY,2985,17,1,3,21
GREEDY,3268,16,0,4,20
GREEDY,2736,18,2,3,23
GREEDY,7943,15,0,2,17
GREEDY,2565,16,2,4,22
STINGY,1038,2,1,2,5
STINGY,1995,2,1,1,4
STINGY,572,3,1,3,7
STINGY,1965,2,0,1,3
STINGY,2066,3,0,2,5
GREEDY,11309,15,2,2,19
GREEDY,5891,15,1,2,18
GREEDY,2155,17,2,2,21
GREEDY,810,14,2,3,19
GREEDY,1005,14,2,3,19
GREEDY,3529,18,1,3,22
STINGY,1884,3,1,2,6
GREEDY,2206,12,2,4,18
GREEDY,4189,17,1,3,21
STINGY,2138,0,0,0,0
GREEDY,3010,17,2,4,23
GREEDY,8283,14,2,3,19
GREEDY,3475,18,1,2,21
GREEDY,2214,13,2,4,19
GREEDY,882,16,2,3,21
GREEDY,1628,15,2,3,20
GREEDY,2234,20,2,4,26
GREEDY,758,13,2,3,18
GREEDY,2138,19,1,2,22
GREEDY,5981,15,2,3,20
GREEDY,583,9,1,2,12
STINGY,2068,6,2,1,9
GREEDY,5584,19,1,3,23
GREEDY,4878,16,2,1,19
STINGY,1126,5,1,0,6
GREEDY,2409,15,1,4,20
STINGY,1306,4,1,0,5
GREEDY,3676,18,2,3,23
STINGY,1396,4,1,0,5
GREEDY,1523,12,2,3,17
GREEDY,4259,19,2,3,24
GREEDY,3946,18,2,4,24
GREEDY,2938,16,1,4,21
STINGY,1848,3,0,2,5
GREEDY,5630,17,2,3,22
STINGY,1425,2,0,2,4
GREEDY,6957,15,2,4,21
STINGY,1408,4,1,0,5
STINGY,2043,0,0,1,1
GREEDY,8550,15,1,3,19
STINGY,1944,6,0,2,8
GREEDY,1168,17,1,3,21
STINGY,1384,1,1,0,2
GREEDY,3055,15,1,4,20
GREEDY,1228,18,1,1,20
GREEDY,2844,12,2,2,16
GREEDY,2950,18,2,1,21
STINGY,1788,2,0,0,2
STINGY,2587,6,1,1,8
STINGY,1555,0,0,2,2
STINGY,1203,2,0,1,3
GREEDY,2929,13,2,4,19
STINGY,1510,3,0,0,3
GREEDY,4656,18,2,3,23
GREEDY,1809,16,2,3,21
STINGY,1110,4,0,1,5
STINGY,1414,1,0,0,1
GREEDY,3170,14,1,2,17
STINGY,1282,2,1,1,4
GREEDY,4433,18,2,2,22
GREEDY,14982,13,2,3,18
GREEDY,5337,16,2,4,22
STINGY,1350,1,0,0,1
GREEDY,826,12,1,4,17
GREEDY,3378,15,1,3,19
STINGY,1166,3,0,2,5
GREEDY,922,14,2,1,17
STINGY,1604,2,0,1,3
GREEDY,2266,17,1,3,21
GREEDY,3058,13,2,3,18
STINGY,1239,1,0,0,1
STINGY,1932,3,0,0,3
STINGY,1665,0,0,1,1
GREEDY,3028,17,1,4,22
GREEDY,3015,15,2,2,19
STINGY,1968,2,1,1,4
STINGY,1524,1,0,0,1
GREEDY,3792,17,0,2,19
GREEDY,1433,16,2,4,22
GREEDY,4422,18,1,2,21
GREEDY,1005,15,1,4,20
GREEDY,3054,16,2,4,22
STINGY,1029,5,1,2,8
GREEDY,5654,16,2,3,21
GREEDY,1643,13,2,3,18
STINGY,1564,3,0,0,3
STINGY,1498,4,0,0,4
GREEDY,6130,17,2,2,21
GREEDY,3335,14,1,2,17
GREEDY,3405,16,2,4,22
GREEDY,7724,16,2,3,21
STINGY,1260,1,1,1,3
GREEDY,5936,16,2,2,20
STINGY,1536,3,1,1,5
GREEDY,2209,15,1,1,17
STINGY,1483,1,0,1,2
GREEDY,5810,15,2,4,21
GREEDY,1530,19,2,3,24
STINGY,1572,2,0,0,2
STINGY,2173,4,1,1,6
GREEDY,1913,14,0,4,18
STINGY,1632,5,1,0,6
GREEDY,1443,16,1,1,18
GREEDY,4565,17,2,4,23
STINGY,1780,5,1,2,8
GREEDY,2409,18,1,4,23
STINGY,2611,2,0,2,4
STINGY,1395,2,1,0,3
STINGY,1642,4,0,2,6
STINGY,1658,0,0,1,1
GREEDY,3703,14,2,2,18
STINGY,1264,2,0,1,3
GREEDY,10127,17,1,3,21
GREEDY,4929,17,2,4,23
GREEDY,2984,18,2,2,22
GREEDY,4222,17,2,2,21
GREEDY,5298,17,1,2,20
STINGY,1409,0,1,2,3
STINGY,1627,4,0,0,4
GREEDY,1917,19,1,3,23
GREEDY,4388,19,1,4,24
STINGY,1529,4,1,1,6
STINGY,1384,4,0,1,5
GREEDY,3457,15,0,3,18
STINGY,711,5,0,0,5
GREEDY,4098,15,2,3,20
GREEDY,2732,15,1,2,18
STINGY,2104,0,0,0,0
GREEDY,3169,16,2,4,22
STINGY,824,3,0,0,3
GREEDY,4199,16,2,4,22
GREEDY,5688,13,2,3,18
STINGY,1364,4,0,1,5
GREEDY,4005,18,2,2,22
GREEDY,3449,15,1,4,20
GREEDY,5713,14,2,3,19
GREEDY,3012,16,2,3,21
GREEDY,2503,19,1,4,24
GREEDY,2389,17,1,3,21
GREEDY,3600,19,2,2,23
GREEDY,2344,18,1,3,22
STINGY,559,6,1,0,7
GREEDY,2308,12,1,3,16
GREEDY,5743,16,2,3,21
STINGY,795,5,0,1,6
GREEDY,3881,15,1,4,20
GREEDY,6376,15,2,1,18
GREEDY,4905,15,1,3,19
STINGY,1062,4,0,1,5
STINGY,1587,2,0,1,3
GREEDY,4441,18,1,2,21
GREEDY,1468,15,2,1,18
GREEDY,771,11,1,4,16
GREEDY,2350,15,2,2,19
STINGY,1421,2,0,0,2
GREEDY,14464,16,0,2,18
STINGY,1844,5,0,3,8
GREEDY,2887,18,2,3,23
GREEDY,2753,14,2,1,17
GREEDY,2944,16,1,3,20
GREEDY,4204,15,2,3,20
STINGY,1627,2,0,0,2
GREEDY,2594,16,1,3,20
GREEDY,4327,17,2,3,22
GREEDY,5716,17,2,2,21
GREEDY,5343,16,1,3,20
GREEDY,4848,17,2,3,22
GREEDY,3187,15,0,1,16
,,,,
GREEDY,1775,9,1,4,14
GREEDY,2170,14,2,3,19
STINGY,2026,0,0,0,0
GREEDY,4873,16,2,3,21
GREEDY,1781,9,1,4,14
GREEDY,6380,17,2,4,23
GREEDY,990,13,1,3,17
GREEDY,5557,18,1,3,22
STINGY,1099,3,0,1,4
GREEDY,3325,13,2,3,18
STINGY,1378,4,0,0,4
GREEDY,2886,18,1,2,21
GREEDY,5094,18,2,3,23
GREEDY,16336,14,2,2,18
GREEDY,7267,16,2,3,21
STINGY,1604,3,0,0,3
STINGY,1802,0,0,0,0
STINGY,2177,1,0,2,3
GREEDY,4558,16,1,2,19
GREEDY,8048,16,2,1,19
GREEDY,2595,12,2,3,17
GREEDY,7323,14,2,4,20
STINGY,1861,5,1,1,7
GREEDY,1739,14,1,4,19
STINGY,1592,4,0,0,4
GREEDY,2904,17,2,2,21
STINGY,2068,5,0,1,6
STINGY,570,4,2,2,8
STINGY,644,4,0,0,4
STINGY,1239,3,1,0,4
STINGY,2121,0,0,0,0
STINGY,1966,3,0,3,6
STINGY,1656,3,0,1,4
STINGY,447,7,0,1,8
GREEDY,7776,17,1,2,20
STINGY,1457,2,0,0,2
STINGY,940,4,0,1,5
STINGY,818,4,1,2,7
GREEDY,2728,15,1,4,20
STINGY,1994,2,1,0,3
GREEDY,3883,15,1,2,18
STINGY,1022,3,0,1,4
STINGY,1368,4,0,2,6
GREEDY,1856,13,1,3,17
STINGY,1688,3,1,0,4
STINGY,1185,4,2,1,7
STINGY,1436,1,0,2,3
GREEDY,2080,18,1,4,23
STINGY,1800,2,0,0,2
STINGY,1885,1,0,1,2
STINGY,18500,7,1,1,9
GREEDY,4067,14,1,4,19
GREEDY,3047,16,2,4,22
STINGY,1166,3,0,1,4
STINGY,1264,1,1,1,3
GREEDY,5151,16,2,3,21
GREEDY,2121,16,2,1,19
GREEDY,2364,17,2,4,23
GREEDY,2742,18,2,3,23
STINGY,1372,4,1,0,5
GREEDY,4065,18,1,3,22
GREEDY,1807,15,2,2,19
GREEDY,2796,17,2,4,23
GREEDY,5689,14,1,2,17
GREEDY,6369,17,2,3,22
GREEDY,4029,18,1,2,21
STINGY,1049,5,0,0,5
GREEDY,2541,16,1,3,20
STINGY,1714,6,0,0,6
GREEDY,2754,16,2,3,21
GREEDY,5004,18,1,3,22
GREEDY,2262,9,1,4,14
GREEDY,6879,15,1,4,20
STINGY,1708,4,0,1,5
STINGY,1773,4,0,2,6
GREEDY,1939,14,1,4,19
STINGY,2024,3,0,1,4
STINGY,1016,6,1,0,7
GREEDY,3169,14,2,3,19
GREEDY,992,12,1,4,17
STINGY,1688,2,0,0,2
STINGY,1401,3,0,0,3
STINGY,2025,0,1,1,2
STINGY,1470,7,1,1,9
GREEDY,2667,14,2,4,20
GREEDY,6743,13,1,4,18
STINGY,878,4,0,0,4
GREEDY,10731,14,1,4,19
GREEDY,1656,14,2,3,19
GREEDY,3872,17,1,3,21
STINGY,1235,1,1,0,2
STINGY,864,3,2,2,7
STINGY,1179,4,0,1,5
GREEDY,5049,17,2,2,21
GREEDY,8354,15,1,3,19
STINGY,1775,6,0,2,8
GREEDY,6026,16,2,3,21
STINGY,1500,0,0,0,0
GREEDY,4702,17,2,3,22
STINGY,1716,2,0,1,3
STINGY,1900,2,1,0,3
GREEDY,2733,17,2,2,21
GREEDY,1554,13,1,4,18
STINGY,1424,3,1,0,4
GREEDY,3340,14,2,3,19
STINGY,881,5,0,2,7
GREEDY,1318,14,0,4,18
GREEDY,4372,17,1,4,22
GREEDY,4813,19,1,3,23
STINGY,1068,3,1,1,5
GREEDY,11447,16,1,2,19
GREEDY,5021,18,1,4,23
GREEDY,2969,17,1,3,21
STINGY,1427,2,1,1,4
STINGY,1034,3,1,0,4
GREEDY,6848,16,2,3,21
GREEDY,3118,15,2,3,20
GREEDY,4332,19,1,3,23
STINGY,1740,3,1,1,5
STINGY,1517,1,1,1,3
GREEDY,3873,16,2,2,20
STINGY,1304,1,1,2,4
STINGY,818,8,0,1,9
STINGY,1521,1,2,1,4
STINGY,1783,3,0,0,3
STINGY,1346,4,0,0,4
STINGY,1992,2,0,0,2
GREEDY,3188,20,1,4,25
STINGY,1120,6,0,0,6
GREEDY,3868,18,0,3,21
STINGY,965,2,1,0,3
GREEDY,2753,16,2,4,22
GREEDY,17002,13,0,3,16
GREEDY,3874,15,2,3,20
GREEDY,2638,18,2,2,22
STINGY,1529,4,1,1,6
GREEDY,4021,14,2,3,19
STINGY,1722,0,1,1,2
GREEDY,4736,13,2,3,18
GREEDY,2358,20,1,1,22
GREEDY,3709,17,1,3,21
GREEDY,2825,16,2,3,21
STINGY,1477,4,0,0,4
GREEDY,1820,19,2,3,24
STINGY,844,4,1,0,5
STINGY,1681,2,0,0,2
STINGY,2148,3,0,0,3
STINGY,875,3,1,1,5
STINGY,1427,5,0,1,6
GREEDY,5199,17,2,4,23
GREEDY,1736,17,2,3,22
GREEDY,3189,15,1,4,20
GREEDY,2301,19,2,3,24
STINGY,1412,2,1,0,3
STINGY,1382,4,0,0,4
GREEDY,5284,17,2,2,21
STINGY,1830,2,0,0,2
STINGY,1490,2,0,0,2
STINGY,2366,1,1,0,2
STINGY,1224,2,0,0,2
GREEDY,1744,16,1,2,19
STINGY,2159,3,0,4,7
GREEDY,4745,14,2,4,20
GREEDY,2325,15,2,3,20
STINGY,1019,7,0,1,8
STINGY,1719,1,1,1,3
GREEDY,3544,15,1,3,19
STINGY,1570,2,0,0,2
STINGY,806,6,1,0,7
GREEDY,4075,16,1,3,20
STINGY,2295,1,0,0,1
GREEDY,2181,17,1,3,21
GREEDY,3346,13,1,4,18
STINGY,1684,3,1,0,4
GREEDY,3210,20,2,3,25
GREEDY,3912,14,0,3,17
GREEDY,2660,11,1,4,16
GREEDY,2269,16,1,2,19
GREEDY,2241,17,1,3,21
STINGY,1342,3,0,1,4
STINGY,1298,4,0,0,4
STINGY,656,6,0,1,7
GREEDY,2534,12,0,4,16
GREEDY,2015,17,2,4,23
GREEDY,16479,16,1,3,20
STINGY,765,6,1,1,8
GREEDY,1318,18,1,2,21
GREEDY,5014,16,2,3,21
STINGY,1478,1,0,0,1
GREEDY,4699,17,2,4,23
GREEDY,3244,14,1,3,18
STINGY,2196,2,0,1,3
GREEDY,1221,17,2,3,22
GREEDY,1973,13,2,4,19
STINGY,1575,2,0,0,2
GREEDY,2280,14,1,4,19
GREEDY,4858,13,2,4,19
GREEDY,3751,19,2,3,24
GREEDY,1606,18,1,3,22
STINGY,1440,5,1,0,6
GREEDY,2787,17,1,2,20
GREEDY,2491,18,2,2,22
GREEDY,3031,16,0,3,19
STINGY,2029,3,0,2,5
GREEDY,545,18,1,4,23
GREEDY,2241,16,2,1,19
GREEDY,11249,16,1,4,21
GREEDY,4233,16,2,3,21
STINGY,1988,0,0,1,1
GREEDY,6116,13,2,4,19
GREEDY,3252,18,1,4,23
GREEDY,2631,17,2,4,23
STINGY,1571,3,0,0,3
GREEDY,2835,15,2,4,21
STINGY,2032,4,1,1,6
GREEDY,1552,14,1,3,18
GREEDY,2940,14,2,4,20
STINGY,2075,3,1,1,5
GREEDY,1589,17,2,2,21
STINGY,1853,1,1,0,2
GREEDY,3071,20,2,2,24
GREEDY,4421,15,2,2,19
GREEDY,2179,16,2,3,21
STINGY,1180,5,0,2,7
STINGY,956,6,0,1,7
GREEDY,3418,18,2,0,20
GREEDY,3342,19,2,2,23
GREEDY,4611,15,2,3,20
GREEDY,976,15,2,4,21
GREEDY,1624,16,2,4,22
STINGY,2413,4,0,0,4
GREEDY,4203,18,2,4,24
GREEDY,944,16,2,2,20
GREEDY,4507,14,1,4,19
STINGY,1750,3,0,1,4
STINGY,1310,6,2,0,8
GREEDY,2207,15,1,3,19
GREEDY,6611,14,1,2,17
GREEDY,1923,15,2,3,20
GREEDY,5639,19,2,2,23
GREEDY,18412,15,1,3,19
STINGY,1664,2,0,1,3
STINGY,772,4,1,0,5
STINGY,1540,1,0,1,2
GREEDY,2080,15,2,3,20
GREEDY,5058,15,2,4,21
STINGY,1554,2,0,1,3
GREEDY,5630,18,1,4,23
STINGY,986,6,0,2,8
GREEDY,6392,14,1,3,18
STINGY,1151,2,0,1,3
GREEDY,7164,15,1,3,19
GREEDY,11485,16,2,4,22
STINGY,868,6,0,1,7
GREEDY,4362,14,2,3,19
GREEDY,5325,13,1,3,17
STINGY,2562,4,1,0,5
GREEDY,1699,17,1,3,21
STINGY,1295,7,0,0,7
STINGY,769,5,0,0,5
STINGY,1674,0,0,0,0
GREEDY,4057,16,1,3,20
STINGY,1234,2,0,1,3
GREEDY,2504,14,1,3,18
STINGY,1004,2,0,1,3
GREEDY,3617,15,1,4,20
GREEDY,6975,18,0,2,20
GREEDY,2812,17,2,2,21
GREEDY,4790,18,0,3,21
STINGY,1468,3,1,0,4
STINGY,1760,2,1,0,3
GREEDY,13234,14,2,2,18
GREEDY,9989,16,2,4,22
GREEDY,2683,15,1,3,19
STINGY,1690,1,0,1,2
GREEDY,4046,16,1,3,20
GREEDY,5425,16,2,2,20
GREEDY,2096,17,2,4,23
GREEDY,2329,16,2,4,22
STINGY,1258,2,0,0,2
GREEDY,4645,17,2,3,22
GREEDY,3837,14,2,4,20
STINGY,1129,3,0,1,4
GREEDY,2186,18,2,3,23
STINGY,734,4,0,1,5
GREEDY,1823,17,1,2,20
STINGY,1954,4,0,2,6
STINGY,833,3,0,1,4
STINGY,2242,5,2,1,8
GREEDY,2446,14,2,3,19
GREEDY,1753,14,1,4,19
GREEDY,3253,14,2,3,19
GREEDY,3678,18,1,4,23
STINGY,1744,5,1,1,7
GREEDY,902,16,2,3,21
STINGY,1722,2,0,0,2
GREEDY,1414,15,1,3,19
STINGY,1635,1,0,0,1
STINGY,1006,3,0,0,3
GREEDY,2703,13,2,3,18
GREEDY,3743,12,2,4,18
GREEDY,1774,15,1,3,19
GREEDY,322,11,0,2,13
GREEDY,1870,15,0,4,19
GREEDY,5854,12,2,2,16
GREEDY,1187,15,2,3,20
GREEDY,3478,16,1,2,19
STINGY,600,6,0,1,7
STINGY,1677,2,1,2,5
STINGY,1474,2,0,0,2
STINGY,926,5,0,0,5
,,,,
GREEDY,1234,10,2,4,16
GREEDY,7009,12,1,2,15
STINGY,1145,3,0,1,4
STINGY,1016,6,0,0,6
GREEDY,3616,15,2,3,20
STINGY,1619,4,0,1,5
STINGY,1411,5,0,1,6
STINGY,1221,1,0,0,1
GREEDY,2242,13,2,2,17
GREEDY,2794,16,2,4,22
GREEDY,7908,14,2,3,19
STINGY,1506,3,0,0,3
STINGY,2050,1,0,0,1
STINGY,1370,2,1,0,3
GREEDY,2582,14,2,3,19
STINGY,1284,3,0,0,3
STINGY,1338,1,0,1,2
GREEDY,3574,14,2,2,18
GREEDY,4684,18,1,3,22
STINGY,1672,1,0,1,2
GREEDY,3485,17,1,2,20
STINGY,1350,2,1,0,3
GREEDY,3328,16,2,3,21
STINGY,2817,6,1,1,8
STINGY,941,3,0,1,4
STINGY,1352,4,0,0,4
STINGY,1020,5,0,2,7
STINGY,1911,2,0,0,2
GREEDY,11482,16,1,3,20
GREEDY,5308,16,1,2,19
STINGY,1387,5,1,1,7
STINGY,2121,1,0,1,2
GREEDY,5780,15,1,3,19
STINGY,1694,0,0,0,0
STINGY,1333,4,0,2,6
STINGY,1606,2,0,0,2
STINGY,1284,3,0,0,3
,,,,
STINGY,1966,4,1,1,6
GREEDY,8964,16,1,3,20
GREEDY,2369,12,2,1,15
GREEDY,4719,17,1,3,21
GREEDY,9359,14,1,3,18
STINGY,1875,2,0,0,2
GREEDY,708,15,2,3,20
GREEDY,2719,16,2,3,21
GREEDY,10874,16,2,2,20
GREEDY,7586,13,2,2,17
GREEDY,5363,16,1,3,20
GREEDY,4566,14,2,4,20
GREEDY,2953,17,1,4,22
GREEDY,2131,14,1,4,19
GREEDY,2171,18,1,4,23
STINGY,2264,1,0,2,3
STINGY,571,5,1,0,6
GREEDY,3925,19,2,3,24
STINGY,1476,6,0,2,8
GREEDY,5151,16,1,2,19
GREEDY,2586,12,2,4,18
STINGY,725,5,2,2,9
STINGY,2080,1,0,0,1
GREEDY,1836,17,2,3,22
STINGY,2203,2,0,0,2
GREEDY,3227,19,2,1,22
GREEDY,4814,18,2,4,24
GREEDY,4115,16,2,2,20
GREEDY,7370,15,1,3,19
STINGY,1823,5,0,1,6
STINGY,1079,1,0,2,3
GREEDY,4904,15,0,4,19
STINGY,1199,2,0,2,4
STINGY,1259,2,0,2,4
GREEDY,3220,18,2,4,24
GREEDY,2722,19,1,4,24
STINGY,1646,4,0,1,5
GREEDY,5405,17,2,2,21
GREEDY,2341,15,2,3,20
STINGY,911,4,0,1,5
STINGY,1504,1,1,0,2
GREEDY,2285,13,1,3,17
STINGY,1140,3,0,0,3
STINGY,1350,2,0,0,2
GREEDY,4495,14,2,3,19
STINGY,912,6,0,1,7
GREEDY,2046,16,2,3,21
STINGY,1249,2,0,1,3
STINGY,2187,2,1,1,4
GREEDY,1443,14,2,3,19
STINGY,1176,4,0,1,5
STINGY,2244,1,0,0,1
GREEDY,3149,15,1,3,19
GREEDY,4125,16,0,4,20
GREEDY,4800,14,1,2,17
GREEDY,1865,17,2,1,20
STINGY,1433,2,0,0,2
GREEDY,4944,18,2,4,24
GREEDY,1676,17,2,3,22
STINGY,1202,3,0,2,5
STINGY,925,5,0,0,5
GREEDY,12524,14,2,2,18
GREEDY,3011,18,1,3,22
STINGY,2153,2,1,1,4
,,,,
GREEDY,2206,15,1,4,20
GREEDY,9095,16,2,3,21
STINGY,599,6,0,0,6
GREEDY,4100,14,2,3,19
GREEDY,1360,13,2,4,19
GREEDY,3215,13,2,2,17
STINGY,1074,3,0,2,5
STINGY,1562,4,0,1,5
STINGY,890,4,0,0,4
GREEDY,2906,18,1,4,23
GREEDY,2187,18,2,3,23
GREEDY,2632,15,1,2,18
STINGY,1159,2,0,1,3
GREEDY,2853,9,1,4,14
GREEDY,1571,18,1,4,23
GREEDY,2341,18,2,4,24
STINGY,1379,5,0,1,6
GREEDY,2082,19,1,3,23
GREEDY,5473,17,2,3,22
GREEDY,4504,13,1,2,16
GREEDY,5515,12,1,3,16
GREEDY,2604,16,1,3,20
GREEDY,7708,15,2,3,20
GREEDY,8703,14,2,3,19
STINGY,1451,5,0,0,5
GREEDY,4391,13,2,4,19
STINGY,1400,7,0,0,7
STINGY,2428,4,1,1,6
STINGY,1140,4,1,0,5
GREEDY,4301,17,2,3,22
STINGY,1071,3,0,2,5
GREEDY,3143,15,2,3,20
STINGY,1500,2,0,1,3
GREEDY,2467,16,2,2,20
STINGY,1657,1,0,0,1
GREEDY,4353,14,0,3,17
GREEDY,2915,16,2,2,20
STINGY,1271,5,0,0,5
GREEDY,3304,13,1,4,18
GREEDY,3509,17,1,4,22
STINGY,2634,5,0,2,7
STINGY,1643,6,0,1,7
GREEDY,3459,18,1,4,23
GREEDY,3136,14,2,4,20
GREEDY,4312,19,1,3,23
GREEDY,1537,13,1,3,17
STINGY,1573,0,0,0,0
STINGY,1532,2,1,1,4
GREEDY,3968,19,2,3,24
STINGY,1560,6,0,1,7
GREEDY,2186,16,1,1,18
STINGY,1667,3,0,0,3
GREEDY,3362,13,1,4,18
GREEDY,2186,15,1,4,20
STINGY,1654,0,0,0,0
STINGY,1840,2,0,0,2
GREEDY,1934,19,1,4,24
GREEDY,4272,14,1,3,18
GREEDY,1916,10,0,3,13
GREEDY,4033,18,0,3,21
STINGY,1309,1,2,1,4
STINGY,1440,5,1,1,7
STINGY,2512,2,0,1,3
GREEDY,1838,12,1,4,17
GREEDY,3693,17,2,3,22
GREEDY,6283,14,1,3,18
GREEDY,1315,13,2,4,19
GREEDY,3079,13,1,4,18
STINGY,1182,2,0,0,2
STINGY,1329,2,0,3,5
STINGY,1111,4,0,0,4
STINGY,1156,5,0,0,5
GREEDY,3118,16,0,4,20
GREEDY,3970,16,2,4,22
STINGY,488,5,0,2,7
STINGY,1485,2,0,1,3
GREEDY,6600,15,2,3,20
GREEDY,8017,17,2,3,22
GREEDY,2128,17,1,4,22
GREEDY,2217,16,1,4,21
GREEDY,3440,18,2,4,24
GREEDY,9012,16,1,2,19
GREEDY,2472,17,2,3,22
GREEDY,13045,15,2,3,20
GREEDY,3736,16,2,4,22
STINGY,1125,3,0,0,3
STINGY,1452,3,0,1,4
GREEDY,2278,13,1,4,18
STINGY,1905,1,0,1,2
STINGY,1986,2,0,0,2
GREEDY,4590,16,2,3,21
STINGY,1359,2,1,0,3
STINGY,2074,2,0,1,3
GREEDY,1842,17,2,3,22
GREEDY,3874,18,1,0,19
STINGY,1440,4,0,1,5
GREEDY,4076,15,2,3,20
GREEDY,3578,16,2,3,21
STINGY,2520,3,1,0,4
STINGY,1928,5,0,0,5
STINGY,1234,2,0,2,4
GREEDY,3290,19,2,2,23
GREEDY,5923,12,2,3,17
GREEDY,5498,16,2,4,22
STINGY,2253,3,0,1,4
GREEDY,2452,19,1,2,22
GREEDY,4636,18,2,3,23
GREEDY,3948,19,2,3,24
GREEDY,3688,17,1,4,22
STINGY,801,5,1,2,8
STINGY,2447,0,0,1,1
GREEDY,1904,16,2,3,21
STINGY,979,1,0,0,1
STINGY,2049,2,1,0,3
GREEDY,489,11,0,4,15
GREEDY,925,5,2,4,11
GREEDY,3057,15,1,4,20
GREEDY,3281,18,2,3,23
GREEDY,8042,15,2,3,20
STINGY,749,6,0,2,8
GREEDY,5193,16,2,3,21
STINGY,1498,5,0,0,5
GREEDY,4170,10,2,3,15
STINGY,1518,1,1,0,2
GREEDY,3104,17,2,3,22
GREEDY,3437,17,1,3,21
GREEDY,3517,16,2,4,22
GREEDY,3748,16,2,4,22
STINGY,987,4,0,0,4
STINGY,1403,8,0,1,9
GREEDY,2925,8,2,4,14
GREEDY,4411,15,2,4,21
GREEDY,5009,16,2,2,20
STINGY,1674,0,0,0,0
STINGY,1301,3,1,0,4
STINGY,1357,5,0,0,5
STINGY,1206,3,1,1,5
GREEDY,2765,17,1,3,21
GREEDY,2164,16,1,1,18
GREEDY,5094,16,2,3,21
GREEDY,3050,14,2,4,20
STINGY,881,5,0,0,5
STINGY,1186,3,0,0,3
GREEDY,713,7,1,2,10
STINGY,1490,4,0,1,5
STINGY,1452,3,0,0,3
STINGY,1180,2,0,0,2
GREEDY,3010,16,2,2,20
STINGY,909,3,0,1,4
GREEDY,5555,15,2,4,21
GREEDY,29328,14,1,3,18
GREEDY,9189,13,2,3,18
STINGY,1762,2,0,2,4
STINGY,1136,3,1,1,5
STINGY,2001,4,0,1,5
GREEDY,2051,11,1,4,16
STINGY,2105,0,0,0,0
GREEDY,11176,15,1,2,18
GREEDY,2425,18,2,2,22
GREEDY,2939,16,1,1,18
STINGY,994,4,0,1,5
GREEDY,81182,12,2,2,16
GREEDY,9447,15,2,3,20
GREEDY,6333,15,2,2,19
GREEDY,6094,16,1,2,19
STINGY,1094,5,0,1,6
STINGY,1346,4,1,0,5
GREEDY,2368,17,2,3,22
STINGY,779,6,1,1,8
GREEDY,2869,16,2,3,21
GREEDY,3355,18,2,1,21
STINGY,1544,1,0,0,1
GREEDY,4515,17,2,4,23
GREEDY,2895,16,2,4,22
STINGY,1540,4,1,1,6
GREEDY,4787,16,0,4,20
GREEDY,7502,15,1,3,19
GREEDY,1601,16,1,4,21
GREEDY,2814,19,2,3,24
STINGY,1520,1,0,0,1
GREEDY,1628,14,1,4,19
GREEDY,4258,16,1,4,21
GREEDY,3961,17,1,1,19
GREEDY,6726,17,2,3,22
STINGY,2058,2,1,1,4
STINGY,1306,2,0,0,2
GREEDY,1051,14,1,4,19
STINGY,1344,2,0,0,2
GREEDY,3843,18,1,2,21
STINGY,1682,3,2,0,5
STINGY,1080,3,0,0,3
GREEDY,5760,14,2,3,19
STINGY,1407,2,0,0,2
STINGY,1465,1,0,0,1
GREEDY,2235,15,2,4,21
STINGY,522,6,0,1,7
STINGY,1475,3,0,0,3
GREEDY,2911,19,2,3,24
STINGY,1085,3,0,3,6
STINGY,1157,5,0,1,6
GREEDY,1673,16,1,4,21
STINGY,1800,6,0,3,9
GREEDY,4643,18,0,3,21
GREEDY,7364,16,1,3,20
GREEDY,6673,14,2,4,20
STINGY,1253,5,0,0,5
GREEDY,2548,17,2,1,20
GREEDY,5520,16,2,3,21
GREEDY,2969,16,1,3,20
STINGY,1408,2,0,1,3
STINGY,1482,8,0,0,8
GREEDY,9243,16,2,3,21
GREEDY,2205,14,2,2,18
GREEDY,2005,13,2,2,17
GREEDY,3531,15,1,4,20
STINGY,2413,4,0,2,6
STINGY,1919,1,0,1,2
STINGY,1460,3,0,0,3
GREEDY,6175,14,1,2,17
GREEDY,1376,19,1,3,23
GREEDY,6115,12,1,2,15
STINGY,868,3,1,1,5
GREEDY,3286,15,1,2,18
STINGY,1052,5,1,0,6
STINGY,1682,9,0,3,12
GREEDY,3047,11,2,2,15
STINGY,1716,0,2,3,5
STINGY,1663,2,0,0,2
GREEDY,4640,13,1,4,18
GREEDY,2928,16,1,3,20
GREEDY,3716,13,2,4,19
STINGY,1286,4,1,2,7
STINGY,1612,1,0,0,1
STINGY,1387,1,0,2,3
GREEDY,3334,17,2,4,23
GREEDY,3503,14,2,2,18
GREEDY,2529,16,1,2,19
STINGY,1070,4,1,0,5
STINGY,1452,2,0,0,2
GREEDY,3969,14,1,3,18
STINGY,2072,0,1,0,1
GREEDY,2027,15,0,4,19
GREEDY,4105,16,1,2,19
GREEDY,4906,15,2,1,18
STINGY,2000,2,0,0,2
STINGY,839,6,1,2,9
STINGY,1435,2,1,0,3
GREEDY,1521,13,1,4,18
GREEDY,4998,15,2,3,20
STINGY,2567,5,0,3,8
STINGY,885,4,0,0,4
STINGY,1448,5,1,0,6
STINGY,1750,1,1,1,3
GREEDY,2420,14,2,1,17
GREEDY,1795,12,2,4,18
STINGY,1631,2,0,1,3
GREEDY,3806,14,2,3,19
GREEDY,3073,19,2,3,24
GREEDY,5623,15,2,3,20
STINGY,1221,5,1,2,8
STINGY,1190,7,0,0,7
GREEDY,1139,16,2,3,21
STINGY,1393,4,0,1,5
STINGY,1585,1,0,0,1
GREEDY,5999,15,1,3,19
GREEDY,12341,15,1,3,19
GREEDY,9722,14,2,3,19
GREEDY,4595,15,1,3,19
GREEDY,3432,18,1,3,22
STINGY,1674,0,1,0,1
GREEDY,2161,15,1,4,20
STINGY,1410,4,0,1,5
STINGY,226,6,0,3,9
GREEDY,5707,15,1,3,19
STINGY,1720,1,0,0,1
STINGY,573,3,0,1,4
STINGY,1263,3,0,1,4
STINGY,1222,3,1,0,4
STINGY,2421,3,1,1,5
GREEDY,3190,17,1,4,22
GREEDY,2308,16,2,2,20
STINGY,1638,5,1,0,6
GREEDY,3994,14,1,1,16
STINGY,1193,3,1,0,4
GREEDY,2785,15,2,4,21
GREEDY,4784,14,2,2,18
GREEDY,3249,17,1,4,22
GREEDY,8199,15,1,3,19
GREEDY,3317,17,1,2,20
STINGY,660,2,0,1,3
GREEDY,5421,18,1,1,20
GREEDY,1776,17,2,4,23
STINGY,1170,2,1,1,4
STINGY,1076,1,1,1,3
GREEDY,5451,15,1,4,20
STINGY,1370,3,0,1,4
GREEDY,1898,16,1,2,19
GREEDY,2011,16,2,3,21
STINGY,1693,6,0,2,8
STINGY,1392,2,0,0,2
GREEDY,800,16,2,1,19
STINGY,1206,3,0,0,3
STINGY,1639,0,1,0,1
GREEDY,1493,14,2,4,20
STINGY,1536,2,0,0,2
GREEDY,958,12,1,1,14
GREEDY,1589,14,2,2,18
STINGY,1228,4,1,0,5
GREEDY,2451,19,1,3,23
GREEDY,1310,16,2,3,21
GREEDY,5840,15,0,4,19
GREEDY,3146,19,1,3,23
GREEDY,4148,16,2,4,22
GREEDY,3379,17,1,3,21
STINGY,1565,2,0,0,2
STINGY,1590,3,1,2,6
STINGY,1574,0,0,1,1
GREEDY,3009,11,2,4,17
STINGY,1757,3,0,1,4
GREEDY,1599,16,2,4,22
STINGY,1658,1,0,0,1
STINGY,1918,2,0,0,2
GREEDY,1264,15,2,4,21
GREEDY,4357,13,0,2,15
GREEDY,6938,14,2,4,20
GREEDY,2489,16,1,4,21
GREEDY,1396,14,2,4,20
GREEDY,3964,18,2,3,23
GREEDY,6300,16,0,3,19
GREEDY,1580,11,1,4,16
STINGY,2215,8,1,2,11
STINGY,1304,1,1,0,2
GREEDY,1028,17,2,2,21
STINGY,1800,2,0,3,5
GREEDY,7657,17,2,3,22
GREEDY,3031,15,1,3,19
GREEDY,6114,14,2,4,20
STINGY,1760,2,0,0,2
STINGY,1622,0,2,0,2
GREEDY,2337,19,1,4,24
GREEDY,1561,13,1,4,18
GREEDY,4420,17,1,3,21
GREEDY,3072,14,2,3,19
STINGY,1580,1,0,0,1
GREEDY,1371,17,1,3,21
GREEDY,3707,18,0,2,20
GREEDY,3537,17,0,3,20
GREEDY,2016,12,2,4,18
GREEDY,2625,18,1,2,21
GREEDY,9011,13,2,3,18
STINGY,658,6,1,1,8
STINGY,1496,4,1,2,7
GREEDY,3264,15,1,2,18
STINGY,1826,2,0,1,3
GREEDY,2523,13,0,3,16
GREEDY,5665,13,2,4,19
STINGY,1449,5,0,2,7
STINGY,1638,0,0,0,0
STINGY,1157,2,0,0,2
STINGY,1890,3,0,1,4
STINGY,2196,2,0,1,3
GREEDY,3739,16,1,2,19
STINGY,2139,3,0,0,3
STINGY,2821,5,0,0,5
,,,,
STINGY,2386,2,0,0,2
STINGY,1795,1,1,2,4
STINGY,1050,5,0,2,7
STINGY,1252,2,0,1,3
GREEDY,1248,13,1,2,16
GREEDY,3269,17,2,2,21
GREEDY,4682,15,2,4,21
GREEDY,2619,15,2,3,20
GREEDY,5814,15,2,3,20
STINGY,695,4,0,1,5
STINGY,1410,4,1,1,6
GREEDY,8655,15,1,3,19
GREEDY,2696,15,2,3,20
STINGY,1793,1,1,0,2
STINGY,1332,5,1,1,7
STINGY,2250,1,0,1,2
GREEDY,863,14,2,3,19
GREEDY,5975,19,2,3,24
GREEDY,1284,13,1,4,18
STINGY,1889,2,0,2,4
GREEDY,8780,17,2,3,22
STINGY,1172,3,1,0,4
STINGY,1110,3,1,1,5
STINGY,1201,4,1,1,6
,,,,
GREEDY,4038,15,2,3,20
GREEDY,1600,18,2,3,23
STINGY,1157,1,0,1,2
GREEDY,5200,13,2,4,19
GREEDY,3343,15,1,3,19
GREEDY,5673,17,2,3,22
STINGY,1804,4,0,0,4
STINGY,1860,2,0,0,2
GREEDY,1820,14,1,4,19
GREEDY,2401,14,0,4,18
GREEDY,3699,18,2,2,22
STINGY,1617,0,0,1,1
STINGY,1315,2,0,0,2
GREEDY,3878,17,0,3,20
STINGY,2331,3,0,2,5
STINGY,1487,1,0,0,1
GREEDY,4417,15,1,2,18
GREEDY,6778,16,1,2,19
GREEDY,2070,14,1,4,19
GREEDY,3842,15,2,4,21
GREEDY,3829,18,2,3,23
STINGY,1601,6,1,0,7
GREEDY,1641,16,1,1,18
GREEDY,1832,15,2,4,21
STINGY,1326,4,1,0,5
GREEDY,1147,13,2,3,18
STINGY,1617,0,0,0,0
STINGY,1084,3,0,1,4
STINGY,1495,1,0,0,1
GREEDY,2293,18,2,2,22
GREEDY,3444,16,2,3,21
GREEDY,1636,12,0,3,15
STINGY,1619,3,0,0,3
GREEDY,2873,19,2,4,25
STINGY,1453,5,0,2,7
GREEDY,11180,18,2,2,22
STINGY,1461,2,1,1,4
GREEDY,2460,18,2,3,23
GREEDY,3012,17,2,3,22
STINGY,3159,2,0,1,3
STINGY,987,5,0,1,6
GREEDY,1431,14,2,3,19
GREEDY,7822,17,1,3,21
GREEDY,7247,16,1,2,19
GREEDY,5514,17,1,2,20
GREEDY,2167,17,1,2,20
GREEDY,2197,12,2,2,16
GREEDY,1558,16,0,4,20
GREEDY,5213,17,1,4,22
STINGY,1912,4,0,0,4
STINGY,2176,3,0,0,3
GREEDY,6197,15,2,2,19
STINGY,892,3,0,2,5
GREEDY,2113,13,2,4,19
STINGY,1150,2,0,0,2
STINGY,788,5,0,0,5
GREEDY,2297,14,2,3,19
STINGY,822,4,0,2,6
STINGY,605,5,0,0,5
GREEDY,7159,17,2,3,22
STINGY,1394,1,0,0,1
GREEDY,6041,15,1,4,20
STINGY,1801,4,0,0,4
GREEDY,6428,16,2,3,21
GREEDY,2315,13,1,4,18
GREEDY,967,13,2,3,18
STINGY,1362,5,0,1,6
GREEDY,4854,17,1,3,21
GREEDY,3833,16,1,2,19
STINGY,918,1,0,0,1
GREEDY,3986,16,2,2,20
GREEDY,5333,15,1,3,19
STINGY,1643,2,0,2,4
STINGY,986,5,0,1,6
STINGY,1762,4,0,0,4
STINGY,1492,2,0,0,2
STINGY,1120,3,0,0,3
GREEDY,3108,16,2,3,21
STINGY,1753,2,0,0,2
GREEDY,8212,15,1,4,20
GREEDY,1910,14,2,4,20
GREEDY,4944,17,2,4,23
GREEDY,2005,21,2,3,26
GREEDY,1994,18,2,3,23
GREEDY,4032,15,1,4,20
STINGY,574,4,1,0,5
GREEDY,1934,16,1,2,19
GREEDY,3841,15,2,3,20
GREEDY,3961,18,2,4,24
GREEDY,2949,18,1,2,21
STINGY,1351,4,0,0,4
GREEDY,1217,18,1,3,22
GREEDY,4847,15,2,3,20
STINGY,1718,2,1,2,5
GREEDY,6384,15,2,3,20
STINGY,1573,2,0,2,4
STINGY,1276,0,0,0,0
GREEDY,1621,17,1,3,21
GREEDY,2439,16,2,3,21
STINGY,1220,1,1,1,3
STINGY,1603,7,0,0,7
GREEDY,3018,15,1,4,20
STINGY,2076,7,2,2,11
STINGY,1664,3,0,0,3
STINGY,1361,5,1,0,6
GREEDY,2174,13,1,3,17
STINGY,1176,2,0,0,2
STINGY,1322,1,0,0,1
STINGY,1191,3,0,0,3
GREEDY,4078,17,0,3,20
GREEDY,6521,16,2,3,21
STINGY,1990,1,0,0,1
GREEDY,3098,19,2,3,24
GREEDY,2265,14,2,2,18
GREEDY,3122,16,1,4,21
STINGY,1888,3,0,0,3
GREEDY,1952,16,2,4,22
GREEDY,1361,20,1,3,24
GREEDY,2294,18,0,2,20
GREEDY,2321,15,2,3,20
STINGY,1267,1,0,1,2
STINGY,1629,4,0,0,4
STINGY,1829,2,0,0,2
STINGY,988,2,1,2,5
STINGY,1263,2,0,1,3
GREEDY,3784,17,2,3,22
GREEDY,6966,15,1,2,18
GREEDY,1448,15,1,3,19
GREEDY,14493,16,1,2,19
GREEDY,597,15,2,3,20
STINGY,1417,0,0,1,1
GREEDY,4954,18,1,4,23
GREEDY,784,12,1,4,17
GREEDY,2693,17,1,1,19
GREEDY,1233,15,2,2,19
GREEDY,2688,16,2,3,21
STINGY,794,6,1,0,7
STINGY,1380,3,1,0,4
GREEDY,5528,16,1,3,20
STINGY,1232,6,0,1,7
GREEDY,3150,16,1,4,21
GREEDY,5063,15,0,4,19
STINGY,1336,5,1,1,7
STINGY,1920,3,1,0,4
STINGY,2359,4,0,1,5
GREEDY,1758,17,1,2,20
STINGY,695,5,0,3,8
GREEDY,2065,19,1,3,23
GREEDY,3181,16,2,2,20
GREEDY,2849,15,2,3,20
GREEDY,4522,15,2,3,20
GREEDY,2816,14,1,4,19
GREEDY,4298,16,1,4,21
GREEDY,1587,13,2,3,18
GREEDY,3022,17,1,3,21
GREEDY,1076,19,2,2,23
STINGY,1556,3,0,1,4
GREEDY,4153,14,2,3,19
GREEDY,17712,16,1,3,20
GREEDY,8032,17,1,3,21
GREEDY,3874,14,2,3,19
GREEDY,2973,19,1,3,23
STINGY,991,4,0,2,6
STINGY,2237,1,1,1,3
GREEDY,1641,15,2,4,21
STINGY,1514,5,0,2,7
GREEDY,1038,14,2,4,20
GREEDY,5072,15,1,3,19
GREEDY,3172,17,1,4,22
STINGY,1459,2,0,0,2
STINGY,1691,2,0,0,2
STINGY,1810,2,2,0,4
GREEDY,3777,17,2,4,23
GREEDY,2789,17,1,3,21
GREEDY,4450,16,1,4,21
GREEDY,3477,13,2,3,18
GREEDY,5346,16,1,3,20
GREEDY,6769,16,2,4,22
GREEDY,3345,16,1,3,20
GREEDY,12935,14,1,1,16
GREEDY,1812,17,1,3,21
GREEDY,1445,19,1,2,22
GREEDY,2173,16,2,2,20
GREEDY,1854,16,2,4,22
GREEDY,1989,14,2,3,19
STINGY,1691,3,0,2,5
GREEDY,1926,14,1,3,18
GREEDY,4580,17,1,2,20
GREEDY,5179,15,2,4,21
STINGY,1820,5,0,2,7
GREEDY,1482,13,2,4,19
GREEDY,3253,16,1,3,20
STINGY,1308,4,1,1,6
GREEDY,3446,16,2,3,21
GREEDY,4284,12,2,4,18
GREEDY,4348,16,2,3,21
GREEDY,3989,16,2,4,22
STINGY,1760,5,1,1,7
GREEDY,3385,18,2,2,22
GREEDY,4778,15,2,3,20
GREEDY,3302,18,2,4,24
STINGY,1503,3,0,1,4
STINGY,1554,3,0,1,4
STINGY,844,3,1,1,5
STINGY,1783,0,0,0,0
STINGY,1851,1,1,0,2
STINGY,1503,0,1,1,2
GREEDY,7496,13,2,3,18
GREEDY,5958,15,1,3,19
STINGY,781,2,0,3,5
GREEDY,4782,15,2,4,21
STINGY,1745,5,2,0,7
GREEDY,3340,17,1,4,22
GREEDY,8619,13,2,2,17
GREEDY,2493,12,1,4,17
GREEDY,3955,17,1,3,21
GREEDY,13410,15,1,4,20
STINGY,1552,0,0,0,0
GREEDY,4498,17,2,3,22
STINGY,2149,2,0,0,2
STINGY,2214,2,1,0,3
GREEDY,3832,19,2,2,23
GREEDY,6914,15,1,2,18
GREEDY,1161,13,1,4,18
STINGY,1650,0,0,0,0
STINGY,1859,0,0,0,0
STINGY,1345,1,0,0,1
STINGY,1400,0,0,0,0
GREEDY,3436,13,1,4,18
STINGY,1483,5,1,0,6
GREEDY,4642,15,2,3,20
GREEDY,5249,16,2,3,21
GREEDY,6662,16,1,2,19
STINGY,1863,4,1,0,5
STINGY,1559,4,0,1,5
GREEDY,6419,19,2,2,23
STINGY,1262,1,0,0,1
GREEDY,1617,13,2,2,17
STINGY,1636,3,0,0,3
GREEDY,3087,15,0,3,18
STINGY,1631,1,0,1,2
GREEDY,2405,17,2,3,22
GREEDY,415,5,1,2,8
GREEDY,5238,18,2,2,22
GREEDY,7106,13,1,4,18
STINGY,1520,1,0,0,1
GREEDY,1946,16,1,3,20
GREEDY,3143,14,1,4,19
STINGY,2742,1,0,1,2
STINGY,1288,1,1,1,3
STINGY,1841,2,0,1,3
GREEDY,5510,15,1,3,19
STINGY,788,2,1,2,5
STINGY,590,7,1,1,9
GREEDY,875,16,1,4,21
STINGY,1588,2,1,0,3
GREEDY,1058,13,0,3,16
GREEDY,2864,15,1,3,19
GREEDY,2371,18,1,3,22
GREEDY,3754,16,2,4,22
STINGY,1573,3,0,1,4
GREEDY,2704,16,2,4,22
STINGY,2816,6,2,1,9
STINGY,2074,3,2,1,6
GREEDY,5486,15,2,3,20
STINGY,211,4,1,0,5
GREEDY,4108,19,2,4,25
STINGY,1603,0,1,0,1
STINGY,1623,1,1,1,3
GREEDY,4011,18,2,3,23
GREEDY,2691,16,2,3,21
GREEDY,3621,19,2,2,23
GREEDY,2903,16,1,3,20
GREEDY,2385,19,1,3,23
GREEDY,2843,14,2,4,20
GREEDY,3545,17,2,3,22
GREEDY,4904,17,2,3,22
STINGY,1475,0,0,2,2
GREEDY,3122,15,2,3,20
STINGY,2387,2,0,2,4
STINGY,1334,3,0,0,3
STINGY,1446,1,0,0,1
GREEDY,1291,15,1,2,18
STINGY,1954,2,0,0,2
GREEDY,8936,14,2,4,20
GREEDY,5122,18,2,2,22
GREEDY,2946,11,1,3,15
STINGY,1390,1,0,0,1
GREEDY,2414,19,2,3,24
,,,,
STINGY,1896,3,0,0,3
GREEDY,1834,15,1,4,20
STINGY,1451,4,0,0,4
STINGY,1104,7,0,0,7
GREEDY,2260,17,1,2,20
GREEDY,2897,12,2,2,16
GREEDY,6396,15,1,3,19
GREEDY,555,13,1,4,18
STINGY,1175,2,0,0,2
GREEDY,2836,16,1,2,19
STINGY,1588,2,0,0,2
GREEDY,16930,14,2,2,18
STINGY,779,6,1,1,8
GREEDY,3348,17,2,2,21
STINGY,1648,1,0,0,1
GREEDY,5709,16,2,3,21
GREEDY,2126,15,2,3,20
GREEDY,3009,17,2,3,22
GREEDY,2536,14,2,4,20
STINGY,766,3,0,1,4
GREEDY,4973,16,2,2,20
GREEDY,657,14,2,3,19
STINGY,1688,2,0,0,2
GREEDY,3589,16,2,3,21
GREEDY,4776,15,2,2,19
GREEDY,5246,15,2,3,20
STINGY,1747,1,1,1,3
GREEDY,2179,16,2,3,21
GREEDY,6922,15,2,4,21
GREEDY,4299,15,2,4,21
GREEDY,2562,14,0,3,17
GREEDY,1868,20,2,1,23
STINGY,1010,2,1,1,4
STINGY,1584,2,0,0,2
GREEDY,7202,15,2,3,20
GREEDY,3338,14,1,3,18
STINGY,1890,3,0,0,3
STINGY,1598,1,0,1,2
STINGY,526,4,0,0,4
GREEDY,2621,18,2,3,23
GREEDY,2245,16,2,4,22
GREEDY,9997,15,1,3,19
GREEDY,4089,19,2,2,23
GREEDY,2810,19,1,4,24
STINGY,1403,1,0,1,2
GREEDY,5172,19,2,3,24
GREEDY,1336,18,1,2,21
GREEDY,4454,14,1,4,19
GREEDY,2299,16,2,3,21
STINGY,845,2,0,1,3
GREEDY,2958,14,2,3,19
GREEDY,1551,12,0,3,15
STINGY,1861,1,1,0,2
GREEDY,3422,14,2,3,19
STINGY,1762,0,0,0,0
STINGY,1646,3,1,1,5
STINGY,880,3,0,1,4
GREEDY,2863,17,2,4,23
GREEDY,2513,17,2,3,22
STINGY,1225,3,0,0,3
GREEDY,3872,15,1,4,20
STINGY,1040,6,0,0,6
STINGY,76,6,0,1,7
STINGY,1922,2,0,2,4
GREEDY,6455,18,2,3,23
STINGY,1079,2,1,1,4
STINGY,560,2,1,0,3
STINGY,1677,3,0,0,3
STINGY,1027,4,0,1,5
GREEDY,2474,15,1,3,19
GREEDY,2015,18,1,4,23
STINGY,1853,1,0,1,2
GREEDY,3987,17,2,3,22
GREEDY,3469,16,1,3,20
STINGY,1969,1,0,1,2
GREEDY,5312,15,2,4,21
GREEDY,2317,16,2,4,22
STINGY,1373,2,1,2,5
STINGY,1729,2,0,2,4
GREEDY,1025,12,1,3,16
STINGY,2124,3,0,2,5
GREEDY,5497,15,2,2,19
STINGY,1180,2,1,0,3
GREEDY,2685,20,1,2,23
GREEDY,2988,17,1,2,20
GREEDY,6427,13,2,3,18
GREEDY,2066,18,0,3,21
STINGY,1868,4,0,0,4
GREEDY,8455,15,1,3,19
GREEDY,4395,18,2,3,23
STINGY,2410,6,0,1,7
GREEDY,11628,15,2,2,19
GREEDY,7703,15,1,4,20
STINGY,857,5,2,1,8
STINGY,1208,3,0,0,3
GREEDY,2156,16,1,4,21
STINGY,1568,4,0,2,6
GREEDY,4101,17,2,3,22
GREEDY,4030,18,1,4,23
GREEDY,4579,18,2,3,23
STINGY,1020,4,1,0,5
STINGY,1320,3,0,2,5
GREEDY,7852,13,2,4,19
GREEDY,3638,17,1,4,22
GREEDY,5055,17,1,2,20
GREEDY,3769,15,1,2,18
GREEDY,11381,16,1,3,20
GREEDY,3307,16,2,3,21
GREEDY,3107,17,1,3,21
STINGY,1198,3,0,0,3
STINGY,1258,1,0,1,2
STINGY,764,4,0,0,4
GREEDY,6104,18,2,2,22
GREEDY,2851,17,1,3,21
GREEDY,9467,16,2,3,21
STINGY,1127,5,0,0,5
GREEDY,4133,14,1,3,18
GREEDY,2302,14,2,3,19
GREEDY,351,11,0,4,15
STINGY,1110,2,0,1,3
STINGY,1548,0,1,1,2
GREEDY,1239,15,2,4,21
GREEDY,1714,17,1,3,21
STINGY,1528,2,0,1,3
GREEDY,1974,17,1,3,21
GREEDY,5939,14,1,3,18
GREEDY,2579,17,1,2,20
STINGY,1289,4,1,1,6
STINGY,908,7,0,2,9
STINGY,1826,2,2,1,5
GREEDY,2908,13,2,4,19
GREEDY,2306,17,1,4,22
GREEDY,7846,15,1,3,19
GREEDY,7440,16,1,4,21
GREEDY,2043,11,2,3,16
STINGY,1155,3,0,1,4
GREEDY,2676,11,1,4,16
STINGY,1464,3,0,0,3
STINGY,1741,8,2,1,11
GREEDY,8947,16,1,3,20
GREEDY,7209,17,2,3,22
GREEDY,3461,18,1,4,23
GREEDY,3425,16,2,3,21
GREEDY,4061,16,1,3,20
STINGY,1517,0,0,0,0
GREEDY,2058,13,1,4,18
GREEDY,4282,16,2,2,20
STINGY,926,5,0,1,6
STINGY,1293,3,0,1,4
GREEDY,3633,15,2,3,20
STINGY,1466,2,2,0,4
STINGY,1324,3,1,0,4
GREEDY,4156,16,1,3,20
GREEDY,2343,15,2,3,20
GREEDY,5066,16,1,2,19
GREEDY,5762,16,1,3,20
GREEDY,5034,15,2,3,20
GREEDY,4584,13,2,3,18
GREEDY,2427,17,1,1,19
GREEDY,4579,16,2,3,21
GREEDY,6058,17,2,4,23
STINGY,1684,3,0,2,5
STINGY,1270,1,0,0,1
GREEDY,5285,14,2,4,20
GREEDY,3629,16,2,3,21
GREEDY,6457,15,1,2,18
STINGY,1310,2,0,1,3
GREEDY,1332,14,1,4,19
STINGY,1865,3,0,0,3
GREEDY,5877,17,2,3,22
STINGY,1119,3,1,1,5
GREEDY,4210,15,2,3,20
GREEDY,3394,19,2,3,24
STINGY,1597,4,1,1,6
STINGY,1579,1,0,0,1
STINGY,1718,0,0,0,0
STINGY,1804,4,0,1,5
STINGY,1323,3,0,1,4
GREEDY,3681,14,2,2,18
GREEDY,4214,16,2,4,22
GREEDY,2603,16,1,4,21
GREEDY,639,12,1,2,15
STINGY,1704,1,1,2,4
STINGY,720,3,1,1,5
STINGY,1031,5,1,2,8
GREEDY,4765,18,2,2,22
STINGY,1584,2,0,1,3
GREEDY,4222,16,2,2,20
STINGY,931,5,0,2,7
GREEDY,3247,19,2,3,24
GREEDY,2582,17,2,4,23
GREEDY,3246,15,1,4,20
STINGY,1214,1,0,0,1
STINGY,1940,0,0,0,0
STINGY,1493,1,0,0,1
GREEDY,2514,10,2,3,15
STINGY,1880,2,0,1,3
GREEDY,3101,16,1,4,21
GREEDY,3768,13,2,3,18
STINGY,1884,2,1,0,3
GREEDY,5721,17,1,3,21
STINGY,1320,2,0,0,2
GREEDY,6436,16,1,3,20
GREEDY,3877,15,2,4,21
GREEDY,2749,17,2,1,20
GREEDY,4384,14,2,4,20
STINGY,1479,2,0,0,2
STINGY,874,5,0,0,5
GREEDY,3477,12,2,4,18
STINGY,1265,4,0,1,5
STINGY,1013,3,0,1,4
STINGY,1536,2,0,1,3
GREEDY,4773,16,1,4,21
GREEDY,32183,14,1,4,19
GREEDY,2295,13,2,4,19
STINGY,1411,5,1,1,7
STINGY,1115,5,0,0,5
GREEDY,2617,16,2,4,22
GREEDY,9152,15,1,2,18
GREEDY,2592,10,2,3,15
GREEDY,5391,16,2,3,21
STINGY,380,4,0,1,5
GREEDY,6304,14,1,3,18
GREEDY,1725,15,1,4,20
STINGY,1419,3,0,1,4
GREEDY,2059,17,1,3,21
STINGY,1583,1,0,1,2
GREEDY,7220,15,2,3,20
GREEDY,5684,18,2,1,21
GREEDY,192,12,1,3,16
GREEDY,1117,13,1,4,18
GREEDY,3532,19,2,3,24
GREEDY,2967,17,2,4,23
STINGY,1901,1,0,0,1
GREEDY,6567,14,2,4,20
STINGY,919,3,1,2,6
GREEDY,5787,16,2,4,22
STINGY,1671,5,1,1,7
STINGY,972,5,0,0,5
STINGY,935,2,0,1,3
STINGY,1657,1,0,0,1
STINGY,1797,2,0,0,2
GREEDY,4611,15,2,3,20
STINGY,1402,2,1,0,3
GREEDY,5586,14,1,3,18
GREEDY,2693,14,2,3,19
STINGY,1556,2,0,0,2
GREEDY,10393,16,2,0,18
GREEDY,2176,14,2,4,20
GREEDY,1344,14,2,3,19
GREEDY,2206,16,2,2,20
STINGY,1682,3,1,1,5
GREEDY,3883,16,1,3,20
GREEDY,3954,16,2,4,22
STINGY,1145,8,1,0,9
STINGY,1297,5,0,0,5
GREEDY,6426,13,0,3,16
GREEDY,2760,17,2,3,22
GREEDY,3358,13,2,4,19
GREEDY,3850,17,1,3,21
,,,,
STINGY,1522,2,0,0,2
GREEDY,4815,17,2,3,22
STINGY,1400,4,0,0,4
STINGY,1347,3,0,0,3
GREEDY,1776,19,2,3,24
GREEDY,2421,12,1,4,17
STINGY,1799,2,1,1,4
STINGY,1877,1,2,0,3
GREEDY,1453,15,1,3,19
GREEDY,2140,14,2,3,19
STINGY,748,4,0,3,7
GREEDY,5571,15,2,4,21
GREEDY,1818,13,2,3,18
GREEDY,2904,16,0,4,20
GREEDY,3657,19,2,4,25
STINGY,1913,1,0,1,2
STINGY,1687,1,1,0,2
GREEDY,3273,22,1,3,26
STINGY,2268,1,0,0,1
STINGY,1030,2,0,0,2
STINGY,1806,2,0,1,3
GREEDY,3797,13,2,2,17
GREEDY,3072,16,2,2,20
STINGY,1210,3,0,1,4
GREEDY,2497,15,2,3,20
GREEDY,2382,13,2,1,16
STINGY,979,4,0,0,4
GREEDY,5217,16,2,3,21
STINGY,1432,4,0,2,6
STINGY,1294,1,0,0,1
GREEDY,3930,17,1,3,21
GREEDY,3032,16,2,3,21
GREEDY,1833,18,1,3,22
STINGY,743,4,1,1,6
STINGY,1456,5,0,2,7
GREEDY,2914,14,1,4,19
STINGY,1009,4,0,1,5
STINGY,1320,1,1,1,3
GREEDY,5093,16,1,3,20
GREEDY,2874,15,2,4,21
STINGY,1575,3,1,0,4
STINGY,1187,3,0,1,4
GREEDY,3044,17,2,3,22
STINGY,1554,1,1,0,2
STINGY,1826,4,0,1,5
STINGY,1295,2,1,1,4
STINGY,2082,0,1,0,1
STINGY,869,7,1,0,8
GREEDY,9452,16,1,4,21
STINGY,1584,3,0,0,3
STINGY,2321,0,0,1,1
GREEDY,1235,15,2,4,21
STINGY,1458,5,0,0,5
STINGY,1893,5,0,1,6
GREEDY,6529,16,2,3,21
STINGY,1513,2,1,2,5
GREEDY,3525,17,1,4,22
STINGY,2084,3,0,2,5
GREEDY,4424,17,1,3,21
GREEDY,4282,17,2,2,21
GREEDY,1244,16,2,3,21
STINGY,1762,2,1,2,5
GREEDY,5379,17,1,3,21
GREEDY,5568,16,2,3,21
STINGY,1408,2,0,0,2
STINGY,2411,5,1,2,8
STINGY,1623,1,0,2,3
GREEDY,3215,17,1,4,22
STINGY,1608,3,0,0,3
STINGY,982,3,0,0,3
GREEDY,7485,15,0,4,19
STINGY,1178,3,0,2,5
GREEDY,4174,14,1,4,19
STINGY,1383,0,0,0,0
STINGY,1315,3,1,0,4
GREEDY,1380,4,0,4,8
GREEDY,4727,16,1,3,20
STINGY,1426,6,0,0,6
GREEDY,2554,17,2,3,22
STINGY,1500,5,0,1,6
GREEDY,2675,15,2,2,19
GREEDY,3642,16,1,3,20
STINGY,1556,2,1,1,4
GREEDY,1477,14,1,4,19
GREEDY,944,16,1,4,21
GREEDY,1172,12,2,4,18
STINGY,1843,3,1,1,5
STINGY,1017,2,0,1,3
GREEDY,3337,17,1,3,21
GREEDY,7363,16,2,2,20
GREEDY,3585,19,2,4,25
GREEDY,1557,14,2,3,19
GREEDY,4171,18,1,2,21
GREEDY,4789,16,2,3,21
STINGY,1843,3,0,1,4
GREEDY,3753,14,1,3,18
GREEDY,2805,17,2,2,21
GREEDY,3588,14,0,4,18
GREEDY,2561,16,2,2,20
GREEDY,3149,20,1,4,25
STINGY,1567,2,1,1,4
STINGY,1561,2,1,2,5
GREEDY,2753,17,2,3,22
GREEDY,3213,18,1,2,21
GREEDY,4378,15,1,3,19
GREEDY,2993,20,1,3,24
GREEDY,1459,19,1,2,22
GREEDY,3401,17,2,2,21
GREEDY,6538,16,2,3,21
GREEDY,1211,12,2,4,18
GREEDY,4968,16,1,4,21
GREEDY,494,9,1,4,14
STINGY,818,3,1,1,5
STINGY,1505,0,0,0,0
GREEDY,4473,12,2,4,18
GREEDY,2491,18,2,4,24
STINGY,1432,2,0,1,3
GREEDY,2942,15,2,3,20
GREEDY,1014,11,1,3,15
GREEDY,3015,17,2,3,22
STINGY,1428,8,1,2,11
GREEDY,1017,13,1,4,18
GREEDY,4725,17,2,3,22
STINGY,1709,0,0,2,2
GREEDY,4584,16,1,3,20
GREEDY,5215,16,0,4,20
GREEDY,2087,14,0,3,17
STINGY,1302,1,0,1,2
STINGY,949,1,1,1,3
GREEDY,2366,17,1,4,22
GREEDY,2624,16,1,4,21
STINGY,2289,2,0,0,2
STINGY,1472,2,1,2,5
STINGY,1640,2,1,1,4
STINGY,1011,4,0,2,6
STINGY,2220,3,0,0,3
GREEDY,2051,19,2,4,25
GREEDY,985,11,2,4,17
STINGY,890,6,0,3,9
STINGY,1189,3,0,1,4
GREEDY,10345,14,1,3,18
GREEDY,6557,16,2,3,21
GREEDY,6252,16,2,1,19
GREEDY,2894,17,2,4,23
STINGY,1800,3,0,1,4
GREEDY,1856,17,1,2,20
GREEDY,2709,14,1,3,18
GREEDY,7985,14,1,4,19
GREEDY,2026,16,2,3,21
GREEDY,4747,16,1,4,21
GREEDY,4582,16,2,3,21
GREEDY,5611,15,2,4,21
STINGY,828,3,0,2,5
STINGY,1992,4,0,1,5
STINGY,1466,2,0,0,2
STINGY,1809,1,0,0,1
GREEDY,2297,15,1,4,20
GREEDY,2947,12,2,1,15
GREEDY,4862,17,2,3,22
GREEDY,4335,14,1,1,16
STINGY,1172,4,0,0,4
STINGY,1660,1,0,0,1
GREEDY,2390,14,1,4,19
GREEDY,3738,17,2,3,22
GREEDY,1530,16,2,3,21
STINGY,1180,5,0,1,6
GREEDY,1214,18,1,1,20
STINGY,1828,1,0,1,2
STINGY,1219,4,1,0,5
STINGY,1749,3,1,0,4
GREEDY,3857,17,2,2,21
STINGY,2097,2,0,1,3
GREEDY,1591,17,2,4,23
GREEDY,4181,18,2,2,22
GREEDY,2509,18,2,4,24
STINGY,1884,0,0,0,0
GREEDY,4838,17,1,2,20
GREEDY,2719,15,2,4,21
STINGY,680,5,1,1,7
STINGY,1313,3,0,1,4
STINGY,942,4,1,0,5
GREEDY,4904,17,1,2,20
STINGY,2507,1,0,1,2
STINGY,1135,2,1,0,3
GREEDY,3984,16,1,4,21
STINGY,634,5,0,1,6
GREEDY,1891,16,2,3,21
GREEDY,3210,16,1,3,20
STINGY,1917,0,0,1,1
STINGY,1211,2,0,3,5
STINGY,1079,2,0,0,2
GREEDY,3210,19,2,3,24
GREEDY,2214,17,2,4,23
STINGY,948,4,0,2,6
GREEDY,1338,12,1,4,17
STINGY,1523,1,1,0,2
STINGY,898,3,0,1,4
STINGY,2360,4,1,1,6
GREEDY,2767,17,2,2,21
GREEDY,4400,19,2,3,24
GREEDY,2118,13,2,4,19
GREEDY,8875,13,1,4,18
GREEDY,3235,19,2,1,22
GREEDY,1949,18,2,4,24
STINGY,1132,3,0,0,3
GREEDY,6441,18,1,2,21
GREEDY,2703,9,2,1,12
GREEDY,3685,18,2,2,22
GREEDY,2917,14,2,4,20
GREEDY,6634,19,2,2,23
GREEDY,2567,15,2,3,20
STINGY,1449,3,1,0,4
GREEDY,2130,15,2,4,21
GREEDY,4118,12,2,2,16
GREEDY,6720,13,2,4,19
STINGY,1786,2,0,0,2
STINGY,1455,2,0,0,2
STINGY,1089,3,1,0,4
GREEDY,1224,13,0,4,17
GREEDY,8470,13,2,3,18
GREEDY,2029,18,2,4,24
STINGY,2437,5,1,3,9
GREEDY,5388,13,1,3,17
GREEDY,3215,16,2,3,21
STINGY,1589,4,0,1,5
STINGY,1598,2,0,0,2
GREEDY,2737,14,2,3,19
