strategy,money,countries,utilities,stations,totalLandsOwned
DEFAULT,280,6,1,2,9
GREEDY,6327,13,1,1,15
GREEDY,5782,11,1,2,14
GREEDY,1458,11,1,4,16
GREEDY,706,6,1,2,9
DEFAULT,542,5,1,2,8
GREEDY,9918,11,1,2,14
GREEDY,3968,13,2,2,17
GREEDY,195,7,1,2,10
DEFAULT,24255,11,1,3,15
DEFAULT,902,7,1,1,9
DEFAULT,328,7,1,1,9
DEFAULT,141,6,1,1,8
GREEDY,6001,14,0,1,15
GREEDY,1801,8,1,4,13
GREEDY,938,4,2,0,6
GREEDY,5679,13,1,1,15
DEFAULT,15819,11,1,3,15
GREEDY,218,7,1,2,10
DEFAULT,820,6,0,1,7
GREEDY,310,12,1,2,15
GREEDY,3504,14,1,3,18
DEFAULT,35318,14,1,1,16
GREEDY,1354,8,1,4,13
DEFAULT,603,5,0,1,6
DEFAULT,38080,12,1,3,16
DEFAULT,331,3,1,0,4
DEFAULT,166,6,0,3,9
DEFAULT,714,11,0,3,14
DEFAULT,708,5,0,2,7
DEFAULT,1295,5,1,2,8
DEFAULT,48804,9,0,1,10
DEFAULT,847,8,0,0,8
DEFAULT,517,9,1,1,11
GREEDY,2342,16,1,3,20
DEFAULT,749,7,0,0,7
GREEDY,4602,12,1,3,16
GREEDY,4384,13,2,3,18
DEFAULT,1097,7,1,4,12
DEFAULT,1852,6,1,0,7
DEFAULT,758,5,0,2,7
GREEDY,2017,8,1,2,11
GREEDY,8313,10,1,3,14
GREEDY,4770,14,2,0,16
DEFAULT,513,5,1,2,8
DEFAULT,792,7,0,1,8
GREEDY,2558,11,2,4,17
DEFAULT,429,7,1,1,9
DEFAULT,585,5,0,0,5
GREEDY,5600,14,2,3,19
DEFAULT,651,7,1,1,9
GREEDY,1940,13,0,4,17
GREEDY,515,9,0,3,12
GREEDY,1404,14,1,3,18
DEFAULT,579,6,0,2,8
GREEDY,6092,12,1,2,15
GREEDY,1874,9,1,3,13
DEFAULT,1182,5,1,1,7
GREEDY,2191,12,1,3,16
DEFAULT,181,10,0,0,10
GREEDY,3983,11,2,4,17
DEFAULT,845,4,1,1,6
GREEDY,3293,11,1,3,15
GREEDY,2738,12,1,2,15
DEFAULT,467,7,2,3,12
GREEDY,3856,13,2,2,17
DEFAULT,1202,5,2,2,9
GREEDY,6686,11,1,3,15
GREEDY,1031,11,1,4,16
DEFAULT,16740,11,2,2,15
DEFAULT,1052,3,0,1,4
GREEDY,4620,11,1,2,14
DEFAULT,739,8,2,2,12
GREEDY,6182,16,1,2,19
DEFAULT,933,8,1,3,12
GREEDY,1172,10,1,4,15
DEFAULT,17585,11,1,1,13
DEFAULT,455,7,0,3,10
GREEDY,1783,12,2,3,17
GREEDY,4360,11,2,2,15
GREEDY,349,8,1,1,10
GREEDY,308,9,1,4,14
GREEDY,6448,10,1,1,12
DEFAULT,1851,7,1,0,8
GREEDY,3237,13,1,4,18
DEFAULT,729,6,1,0,7
DEFAULT,740,5,1,0,6
GREEDY,358,11,1,0,12
GREEDY,4004,14,1,3,18
DEFAULT,1089,4,0,2,6
DEFAULT,846,8,0,2,10
GREEDY,1621,7,1,3,11
GREEDY,7418,12,1,2,15
DEFAULT,504,7,1,1,9
DEFAULT,1127,2,0,1,3
DEFAULT,1158,5,1,1,7
GREEDY,1395,10,0,4,14
GREEDY,2286,13,0,3,16
DEFAULT,457,6,1,1,8
DEFAULT,975,8,1,1,10
DEFAULT,576,9,0,3,12
DEFAULT,15601,13,0,1,14
GREEDY,23,6,0,1,7
DEFAULT,509,8,1,1,10
DEFAULT,502,7,0,1,8
DEFAULT,1414,4,0,0,4
DEFAULT,8038,10,1,2,13
GREEDY,2619,11,0,1,12
GREEDY,7203,13,1,3,17
GREEDY,2575,15,1,2,18
DEFAULT,766,9,0,3,12
DEFAULT,214,6,1,1,8
DEFAULT,172,6,0,3,9
GREEDY,5784,14,0,2,16
GREEDY,86,10,1,0,11
GREEDY,5102,14,1,3,18
GREEDY,688,6,1,1,8
GREEDY,2784,15,1,3,19
GREEDY,267,8,0,2,10
GREEDY,12879,13,1,3,17
GREEDY,1070,5,0,4,9
GREEDY,1131,12,0,4,16
GREEDY,2769,13,0,3,16
GREEDY,5026,11,0,2,13
DEFAULT,1305,1,0,0,1
GREEDY,372,10,1,1,12
DEFAULT,519,6,0,4,10
DEFAULT,614,6,2,1,9
DEFAULT,39358,11,0,2,13
GREEDY,2776,12,2,2,16
GREEDY,496,10,0,2,12
DEFAULT,19260,8,2,2,12
DEFAULT,960,6,0,1,7
DEFAULT,900,5,0,2,7
GREEDY,3250,11,1,3,15
GREEDY,943,7,1,4,12
GREEDY,1593,12,2,3,17
DEFAULT,600,5,2,1,8
DEFAULT,1216,4,1,0,5
DEFAULT,466,7,0,2,9
DEFAULT,168,6,1,2,9
GREEDY,57,5,1,3,9
DEFAULT,61226,11,0,2,13
GREEDY,1631,12,0,1,13
DEFAULT,870,7,0,1,8
GREEDY,1639,11,2,3,16
DEFAULT,22280,11,1,2,14
GREEDY,2170,12,1,3,16
DEFAULT,1771,10,0,2,12
GREEDY,551,7,0,3,10
DEFAULT,372,8,0,2,10
DEFAULT,1210,3,1,2,6
DEFAULT,1679,1,1,0,2
DEFAULT,1036,7,2,3,12
DEFAULT,1006,7,0,2,9
DEFAULT,8284,12,1,2,15
DEFAULT,437,4,1,2,7
DEFAULT,1124,5,1,2,8
GREEDY,7950,15,0,2,17
GREEDY,9714,12,0,3,15
GREEDY,3015,11,2,3,16
DEFAULT,433,5,1,0,6
DEFAULT,1252,4,0,0,4
DEFAULT,110,9,1,1,11
DEFAULT,1282,7,1,2,10
GREEDY,388,10,1,0,11
GREEDY,2716,15,1,3,19
GREEDY,1639,11,1,0,12
GREEDY,11916,11,1,2,14
GREEDY,3085,9,2,3,14
DEFAULT,270,6,1,1,8
DEFAULT,1010,2,0,1,3
GREEDY,204,7,1,0,8
GREEDY,6080,15,1,1,17
DEFAULT,461,7,0,3,10
DEFAULT,299,10,0,1,11
DEFAULT,592,8,0,1,9
DEFAULT,830,4,1,1,6
GREEDY,2445,10,2,2,14
GREEDY,376,5,2,1,8
DEFAULT,670,10,1,1,12
DEFAULT,946,5,1,0,6
GREEDY,165,13,0,1,14
GREEDY,2973,10,2,3,15
GREEDY,3978,10,1,3,14
GREEDY,76,9,2,1,12
GREEDY,571,10,2,1,13
DEFAULT,248,7,2,0,9
DEFAULT,995,4,1,1,6
GREEDY,5902,14,2,2,18
GREEDY,4805,10,1,2,13
DEFAULT,675,4,1,0,5
DEFAULT,996,6,0,1,7
DEFAULT,559,7,0,3,10
DEFAULT,17758,10,1,2,13
DEFAULT,24536,11,0,2,13
GREEDY,15406,14,1,2,17
DEFAULT,485,8,2,2,12
DEFAULT,580,9,2,2,13
GREEDY,701,9,0,0,9
DEFAULT,885,4,0,2,6
GREEDY,32888,12,2,3,17
DEFAULT,1117,7,2,0,9
GREEDY,924,11,2,4,17
GREEDY,11778,14,0,2,16
DEFAULT,1420,6,1,2,9
GREEDY,3803,13,1,3,17
GREEDY,658,5,1,4,10
GREEDY,298,13,1,4,18
GREEDY,2275,10,1,2,13
DEFAULT,24625,11,1,3,15
GREEDY,5566,14,1,2,17
GREEDY,901,11,2,2,15
GREEDY,17407,13,1,4,18
GREEDY,1953,7,2,4,13
DEFAULT,680,10,0,1,11
DEFAULT,205,6,1,0,7
GREEDY,5517,14,2,2,18
GREEDY,2750,14,1,3,18
GREEDY,7166,13,1,2,16
DEFAULT,760,3,2,0,5
DEFAULT,865,5,1,1,7
DEFAULT,1430,7,2,3,12
GREEDY,851,13,1,2,16
DEFAULT,667,7,0,0,7
DEFAULT,9125,10,1,1,12
DEFAULT,928,8,1,3,12
GREEDY,60,9,1,0,10
DEFAULT,772,3,1,2,6
GREEDY,1730,11,0,3,14
GREEDY,7082,14,2,3,19
GREEDY,299,9,1,1,11
DEFAULT,464,4,0,1,5
GREEDY,6944,15,2,3,20
DEFAULT,1415,5,0,0,5
GREEDY,922,5,0,0,5
GREEDY,716,11,1,3,15
GREEDY,992,6,0,3,9
GREEDY,2366,9,1,4,14
GREEDY,1932,12,1,2,15
GREEDY,2886,10,0,3,13
GREEDY,6017,13,1,3,17
DEFAULT,1527,7,0,0,7
GREEDY,4547,12,1,3,16
DEFAULT,14172,11,1,2,14
GREEDY,62798,13,0,2,15
DEFAULT,53986,11,1,1,13
DEFAULT,372,6,2,2,10
DEFAULT,1127,6,0,4,10
DEFAULT,1177,4,0,0,4
DEFAULT,945,2,1,4,7
GREEDY,2590,11,2,3,16
DEFAULT,849,9,0,1,10
DEFAULT,704,6,2,2,10
GREEDY,6127,12,1,2,15
GREEDY,8569,14,1,2,17
DEFAULT,65236,10,1,1,12
DEFAULT,9350,10,0,3,13
GREEDY,3396,14,1,2,17
GREEDY,1642,11,0,3,14
GREEDY,608,6,1,3,10
DEFAULT,1558,6,0,1,7
DEFAULT,7508,12,0,1,13
DEFAULT,3668,8,1,2,11
GREEDY,942,10,1,3,14
DEFAULT,384,6,1,2,9
GREEDY,3706,16,2,1,19
DEFAULT,9345,12,1,1,14
DEFAULT,1009,6,2,1,9
DEFAULT,658,6,1,0,7
GREEDY,214,10,1,2,13
GREEDY,3822,11,1,2,14
GREEDY,770,10,1,3,14
DEFAULT,12725,13,0,2,15
GREEDY,9976,14,2,3,19
DEFAULT,57288,11,1,0,12
GREEDY,4268,17,1,2,20
DEFAULT,21551,10,1,2,13
DEFAULT,1703,8,1,3,12
GREEDY,1929,13,1,2,16
GREEDY,565,6,1,1,8
GREEDY,10411,11,1,2,14
GREEDY,1778,13,1,2,16
GREEDY,446,10,1,0,11
GREEDY,4139,7,2,2,11
DEFAULT,1106,3,0,1,4
GREEDY,1964,14,1,1,16
GREEDY,1148,14,1,1,16
DEFAULT,496,5,1,1,7
DEFAULT,461,9,0,2,11
GREEDY,2070,10,2,2,14
GREEDY,2833,15,1,3,19
DEFAULT,1168,6,1,3,10
GREEDY,1397,11,1,4,16
DEFAULT,18870,12,1,1,14
GREEDY,472,8,0,2,10
GREEDY,1615,14,1,1,16
DEFAULT,782,7,0,2,9
GREEDY,1086,13,2,3,18
DEFAULT,1847,6,1,3,10
DEFAULT,1284,2,0,0,2
DEFAULT,1086,3,0,3,6
DEFAULT,273,5,0,2,7
DEFAULT,1470,7,1,3,11
GREEDY,586,7,2,3,12
DEFAULT,378,4,0,1,5
DEFAULT,921,7,0,2,9
DEFAULT,27328,11,1,1,13
DEFAULT,23550,15,2,1,18
GREEDY,4779,12,2,2,16
GREEDY,571,7,1,3,11
DEFAULT,204,8,0,1,9
GREEDY,690,11,1,3,15
DEFAULT,86674,10,1,3,14
DEFAULT,514,4,0,2,6
GREEDY,7000,13,2,2,17
GREEDY,1068,12,2,2,16
DEFAULT,1040,5,0,0,5
DEFAULT,18439,13,1,1,15
GREEDY,1865,8,2,3,13
GREEDY,4891,12,1,2,15
GREEDY,1909,13,2,3,18
GREEDY,259,12,1,3,16
GREEDY,3486,15,1,2,18
GREEDY,612,9,1,4,14
DEFAULT,592,3,1,2,6
DEFAULT,578,5,1,0,6
GREEDY,12233,10,1,3,14
GREEDY,3543,14,1,2,17
GREEDY,5723,13,1,2,16
DEFAULT,1240,3,0,1,4
GREEDY,1667,12,2,3,17
DEFAULT,503,6,2,2,10
GREEDY,334,7,1,4,12
GREEDY,3012,11,2,2,15
GREEDY,6121,12,1,3,16
GREEDY,3163,14,1,2,17
DEFAULT,1313,3,1,2,6
DEFAULT,1703,8,0,3,11
GREEDY,9531,13,2,2,17
DEFAULT,854,7,1,3,11
DEFAULT,1020,4,2,3,9
GREEDY,2374,14,2,2,18
GREEDY,1219,13,2,4,19
GREEDY,1355,13,0,3,16
DEFAULT,722,5,1,3,9
GREEDY,54258,14,2,1,17
DEFAULT,1226,4,0,1,5
GREEDY,2333,14,1,3,18
GREEDY,2221,16,1,3,20
GREEDY,593,4,1,2,7
DEFAULT,603,6,1,2,9
DEFAULT,854,4,0,2,6
GREEDY,4353,12,1,3,16
GREEDY,905,13,1,3,17
GREEDY,4886,12,1,2,15
DEFAULT,1051,3,0,0,3
DEFAULT,467,6,1,1,8
DEFAULT,222,6,1,2,9
DEFAULT,972,7,1,1,9
DEFAULT,295,5,0,2,7
GREEDY,835,10,2,2,14
GREEDY,1673,12,1,3,16
GREEDY,2148,12,1,3,16
DEFAULT,935,7,0,1,8
DEFAULT,276,8,0,1,9
GREEDY,476,5,1,2,8
DEFAULT,939,8,0,2,10
DEFAULT,600,6,0,1,7
DEFAULT,26628,14,0,3,17
GREEDY,364,10,0,1,11
DEFAULT,730,7,0,0,7
GREEDY,5172,11,2,3,16
GREEDY,1348,10,1,4,15
DEFAULT,724,2,2,1,5
GREEDY,7316,11,2,3,16
DEFAULT,342,10,1,1,12
DEFAULT,536,6,0,2,8
GREEDY,3173,13,1,3,17
DEFAULT,22497,11,0,1,12
DEFAULT,630,5,0,2,7
GREEDY,1239,10,1,4,15
GREEDY,908,9,0,2,11
GREEDY,2045,14,1,4,19
DEFAULT,434,6,1,1,8
GREEDY,2894,12,2,2,16
DEFAULT,42181,10,0,1,11
DEFAULT,188,7,1,2,10
DEFAULT,2023,8,1,3,12
DEFAULT,1666,11,1,3,15
DEFAULT,820,5,1,0,6
GREEDY,1317,12,1,3,16
GREEDY,956,8,1,0,9
DEFAULT,42543,9,0,2,11
DEFAULT,1187,6,1,0,7
GREEDY,266,11,1,1,13
DEFAULT,949,5,2,2,9
GREEDY,6230,14,1,3,18
DEFAULT,1314,2,1,2,5
GREEDY,420,8,1,1,10
DEFAULT,663,8,2,3,13
GREEDY,3543,11,2,4,17
GREEDY,7759,14,1,1,16
DEFAULT,10542,12,1,1,14
GREEDY,43045,11,1,3,15
GREEDY,2615,13,1,2,16
GREEDY,1181,11,1,3,15
DEFAULT,1225,1,1,1,3
GREEDY,1735,10,1,1,12
DEFAULT,1435,6,0,2,8
DEFAULT,466,7,2,1,10
DEFAULT,20865,12,0,2,14
DEFAULT,1513,9,0,3,12
GREEDY,336,5,1,3,9
GREEDY,289,6,0,3,9
DEFAULT,976,7,0,0,7
GREEDY,1966,13,0,3,16
DEFAULT,541,7,0,2,9
DEFAULT,513,7,0,1,8
GREEDY,397,8,1,2,11
DEFAULT,438,6,1,3,10
GREEDY,2744,10,2,1,13
GREEDY,2101,12,1,2,15
GREEDY,302,8,2,3,13
GREEDY,4717,14,2,3,19
GREEDY,2793,14,0,2,16
DEFAULT,456,7,1,0,8
GREEDY,12545,11,1,1,13
DEFAULT,705,7,0,2,9
GREEDY,1023,8,1,2,11
DEFAULT,718,9,0,2,11
GREEDY,2257,14,2,2,18
GREEDY,458,7,0,3,10
GREEDY,1052,7,2,3,12
DEFAULT,336,7,0,2,9
GREEDY,1969,11,0,3,14
DEFAULT,622,8,1,1,10
GREEDY,1081,5,1,1,7
GREEDY,3088,12,1,1,14
DEFAULT,256,5,2,0,7
DEFAULT,1301,5,1,1,7
DEFAULT,638,10,1,2,13
DEFAULT,905,6,0,2,8
DEFAULT,1050,3,1,3,7
GREEDY,4224,11,2,4,17
DEFAULT,1259,6,2,3,11
GREEDY,481,8,1,2,11
DEFAULT,1473,1,0,0,1
DEFAULT,490,5,0,1,6
GREEDY,4171,12,0,2,14
GREEDY,4555,10,0,1,11
GREEDY,3018,11,1,3,15
GREEDY,16372,15,2,2,19
DEFAULT,1880,3,0,2,5
DEFAULT,18363,11,1,2,14
DEFAULT,50,10,1,2,13
DEFAULT,262,4,0,3,7
DEFAULT,310,4,1,1,6
GREEDY,1045,8,2,4,14
GREEDY,4884,11,2,4,17
DEFAULT,564,5,1,1,7
GREEDY,133,8,0,1,9
DEFAULT,24787,11,2,1,14
GREEDY,678,10,1,3,14
GREEDY,3927,11,1,3,15
DEFAULT,642,7,1,2,10
DEFAULT,604,7,0,1,8
DEFAULT,962,5,0,0,5
GREEDY,279,10,2,3,15
DEFAULT,1446,3,0,0,3
DEFAULT,24762,12,1,1,14
GREEDY,8861,12,0,1,13
DEFAULT,19550,12,0,3,15
GREEDY,8387,12,1,3,16
DEFAULT,961,9,2,4,15
DEFAULT,671,7,0,0,7
GREEDY,1026,11,0,3,14
DEFAULT,988,4,0,1,5
GREEDY,3118,16,1,2,19
DEFAULT,1754,1,0,4,5
GREEDY,7196,13,1,2,16
GREEDY,713,9,0,3,12
GREEDY,552,5,0,0,5
DEFAULT,202,9,1,1,11
GREEDY,4298,12,1,0,13
DEFAULT,377,10,1,2,13
DEFAULT,1924,13,1,2,16
DEFAULT,403,7,0,1,8
GREEDY,2575,16,0,2,18
GREEDY,100,12,1,1,14
DEFAULT,669,8,1,3,12
DEFAULT,166,9,0,2,11
DEFAULT,15867,11,1,2,14
DEFAULT,599,5,0,1,6
DEFAULT,177,4,0,2,6
GREEDY,5548,15,2,2,19
GREEDY,951,11,2,3,16
GREEDY,984,7,1,2,10
DEFAULT,13976,11,2,2,15
GREEDY,254,6,0,2,8
DEFAULT,51,7,1,2,10
DEFAULT,903,3,0,2,5
GREEDY,9508,12,1,2,15
DEFAULT,583,7,0,1,8
DEFAULT,178,7,1,0,8
DEFAULT,1000,5,1,3,9
DEFAULT,430,6,2,1,9
DEFAULT,1091,6,2,3,11
DEFAULT,257,8,1,3,12
GREEDY,1697,12,1,2,15
DEFAULT,23481,9,1,1,11
GREEDY,2199,9,0,3,12
DEFAULT,1138,2,1,0,3
DEFAULT,2645,12,1,2,15
DEFAULT,428,9,1,0,10
GREEDY,286,7,2,3,12
GREEDY,19478,10,0,3,13
DEFAULT,1640,2,0,2,4
DEFAULT,939,4,0,0,4
DEFAULT,448,5,0,2,7
GREEDY,7350,11,1,3,15
GREEDY,4841,11,1,3,15
GREEDY,4171,13,1,3,17
DEFAULT,485,5,1,2,8
DEFAULT,635,8,0,3,11
DEFAULT,995,8,1,3,12
DEFAULT,1204,2,1,1,4
DEFAULT,1453,6,1,2,9
DEFAULT,1224,11,0,3,14
DEFAULT,480,7,0,2,9
GREEDY,2296,12,2,2,16
DEFAULT,12245,13,1,3,17
GREEDY,877,10,1,3,14
DEFAULT,425,7,1,2,10
DEFAULT,577,10,1,1,12
GREEDY,6624,16,1,1,18
DEFAULT,712,6,1,2,9
GREEDY,3995,15,1,3,19
DEFAULT,1386,8,2,1,11
GREEDY,3239,14,1,3,18
DEFAULT,742,6,1,1,8
GREEDY,2405,11,1,3,15
DEFAULT,884,8,1,3,12
GREEDY,2254,13,2,3,18
DEFAULT,18056,9,1,2,12
DEFAULT,3214,8,1,1,10
GREEDY,905,12,1,3,16
DEFAULT,36913,11,1,1,13
DEFAULT,20408,11,1,1,13
DEFAULT,681,7,2,1,10
GREEDY,2100,8,1,4,13
DEFAULT,6571,13,1,3,17
DEFAULT,101,7,0,1,8
GREEDY,184,9,0,2,11
DEFAULT,732,7,0,1,8
DEFAULT,181,8,1,0,9
DEFAULT,10102,11,0,1,12
DEFAULT,621,4,2,1,7
DEFAULT,752,8,1,2,11
GREEDY,6370,11,0,3,14
GREEDY,5562,13,2,2,17
GREEDY,2275,14,1,2,17
DEFAULT,966,5,0,1,6
GREEDY,1579,12,2,3,17
GREEDY,3528,14,2,1,17
GREEDY,4650,14,2,0,16
GREEDY,2039,12,2,3,17
GREEDY,1610,14,1,1,16
GREEDY,847,5,1,1,7
GREEDY,6905,13,1,1,15
GREEDY,3538,14,1,2,17
GREEDY,880,8,2,4,14
DEFAULT,206,9,1,1,11
DEFAULT,1423,9,1,1,11
DEFAULT,7562,10,1,2,13
GREEDY,5760,13,1,3,17
GREEDY,2149,11,1,3,15
DEFAULT,341,6,0,2,8
DEFAULT,1526,6,0,1,7
GREEDY,7704,12,1,3,16
DEFAULT,8716,12,2,2,16
DEFAULT,5769,12,2,3,17
GREEDY,27040,13,0,2,15
GREEDY,7617,14,0,2,16
GREEDY,1762,14,2,4,20
DEFAULT,684,6,1,1,8
DEFAULT,1633,8,0,3,11
DEFAULT,4521,12,1,2,15
DEFAULT,481,9,2,3,14
GREEDY,1899,14,1,2,17
GREEDY,6955,14,1,3,18
GREEDY,34147,14,1,2,17
GREEDY,10824,15,1,3,19
GREEDY,6322,12,1,2,15
DEFAULT,1072,3,0,0,3
DEFAULT,8814,10,1,1,12
GREEDY,10601,10,2,2,14
DEFAULT,1269,5,1,2,8
DEFAULT,801,6,0,0,6
DEFAULT,17455,12,0,3,15
DEFAULT,8248,12,1,3,16
DEFAULT,7179,10,0,3,13
GREEDY,7050,14,1,2,17
DEFAULT,984,6,1,4,11
DEFAULT,1685,5,1,3,9
GREEDY,13483,14,1,3,18
DEFAULT,1142,4,2,1,7
GREEDY,21608,12,1,2,15
GREEDY,12666,13,1,2,16
DEFAULT,1492,4,0,1,5
DEFAULT,1145,7,0,0,7
DEFAULT,830,6,0,0,6
DEFAULT,1281,8,1,2,11
DEFAULT,1153,9,1,3,13
DEFAULT,94,5,0,2,7
DEFAULT,1972,10,2,2,14
DEFAULT,875,5,0,0,5
DEFAULT,27197,12,1,1,14
GREEDY,400,9,1,3,13
DEFAULT,790,9,0,3,12
GREEDY,135,9,0,1,10
DEFAULT,636,8,0,1,9
GREEDY,222,8,1,2,11
DEFAULT,2041,9,2,1,12
DEFAULT,4482,11,1,1,13
GREEDY,5249,12,2,2,16
DEFAULT,2261,13,0,4,17
DEFAULT,1404,9,1,2,12
GREEDY,926,4,1,0,5
GREEDY,5397,11,1,4,16
GREEDY,983,7,2,0,9
GREEDY,2610,10,1,3,14
DEFAULT,1024,7,1,3,11
GREEDY,5213,10,1,3,14
GREEDY,10156,14,0,3,17
DEFAULT,1789,13,2,3,18
GREEDY,5765,12,1,3,16
DEFAULT,1148,4,1,2,7
GREEDY,862,9,0,3,12
DEFAULT,781,9,0,1,10
GREEDY,2142,15,1,3,19
GREEDY,6830,12,1,2,15
DEFAULT,1159,8,0,3,11
GREEDY,12705,13,0,2,15
DEFAULT,12754,13,0,2,15
DEFAULT,958,6,0,2,8
DEFAULT,733,9,2,0,11
GREEDY,4005,13,1,4,18
DEFAULT,575,9,2,3,14
GREEDY,76225,15,1,2,18
GREEDY,560,11,1,2,14
GREEDY,5083,13,2,2,17
GREEDY,5599,13,1,3,17
GREEDY,6581,9,2,3,14
GREEDY,2612,13,1,2,16
DEFAULT,28134,8,1,1,10
GREEDY,1438,11,2,1,14
GREEDY,10745,11,2,1,14
DEFAULT,837,3,1,1,5
GREEDY,3557,12,1,1,14
DEFAULT,1132,2,1,0,3
GREEDY,14616,11,1,3,15
DEFAULT,769,5,0,1,6
DEFAULT,674,4,1,0,5
DEFAULT,878,4,0,1,5
GREEDY,2521,9,1,2,12
DEFAULT,1007,6,0,1,7
GREEDY,350,8,0,0,8
DEFAULT,6773,10,1,2,13
DEFAULT,987,4,2,1,7
DEFAULT,892,4,1,1,6
GREEDY,369,9,0,2,11
DEFAULT,1240,6,0,0,6
DEFAULT,681,6,1,2,9
DEFAULT,572,5,0,2,7
GREEDY,584,4,1,1,6
GREEDY,3939,14,2,2,18
DEFAULT,704,7,1,3,11
DEFAULT,394,10,0,3,13
GREEDY,2698,15,0,3,18
DEFAULT,903,3,0,2,5
GREEDY,829,9,1,4,14
DEFAULT,666,9,0,2,11
DEFAULT,530,5,0,0,5
GREEDY,597,9,0,2,11
DEFAULT,1206,4,1,1,6
GREEDY,11394,14,1,3,18
DEFAULT,80,5,1,1,7
GREEDY,2162,12,1,3,16
DEFAULT,404,7,2,2,11
DEFAULT,861,4,0,0,4
GREEDY,3358,12,1,2,15
GREEDY,3268,14,0,3,17
GREEDY,8284,13,1,1,15
DEFAULT,518,6,0,2,8
DEFAULT,543,7,0,0,7
DEFAULT,693,4,0,1,5
GREEDY,1286,12,2,2,16
GREEDY,3108,16,1,1,18
DEFAULT,859,4,0,3,7
GREEDY,13464,14,1,2,17
DEFAULT,20210,12,0,1,13
DEFAULT,1563,3,0,1,4
DEFAULT,26925,9,1,3,13
DEFAULT,15978,12,0,2,14
GREEDY,1698,8,1,4,13
GREEDY,6620,14,2,1,17
GREEDY,3426,16,1,2,19
DEFAULT,9449,10,1,2,13
GREEDY,1243,9,1,4,14
DEFAULT,24,6,1,2,9
DEFAULT,822,4,2,1,7
GREEDY,1119,14,1,4,19
DEFAULT,765,6,1,1,8
GREEDY,5399,13,0,2,15
DEFAULT,8568,11,1,1,13
GREEDY,1066,8,1,4,13
GREEDY,2459,12,2,4,18
DEFAULT,1702,7,1,2,10
GREEDY,9578,12,0,2,14
DEFAULT,431,8,0,1,9
DEFAULT,397,9,1,0,10
GREEDY,2848,8,0,1,9
DEFAULT,1104,6,0,1,7
DEFAULT,5167,8,1,2,11
DEFAULT,1303,6,1,0,7
DEFAULT,945,6,0,2,8
DEFAULT,15407,15,0,1,16
GREEDY,2427,15,2,2,19
GREEDY,194,9,1,2,12
GREEDY,6102,10,1,4,15
GREEDY,2018,12,1,2,15
GREEDY,5505,12,1,3,16
DEFAULT,594,6,1,0,7
GREEDY,261,6,2,1,9
DEFAULT,1150,3,0,3,6
GREEDY,6482,12,2,3,17
GREEDY,6503,13,1,2,16
GREEDY,2459,17,1,3,21
GREEDY,1819,12,1,3,16
GREEDY,2428,11,0,3,14
GREEDY,4136,14,0,3,17
GREEDY,3758,10,0,3,13
DEFAULT,60377,11,0,2,13
GREEDY,4340,14,2,3,19
DEFAULT,204,9,1,3,13
DEFAULT,1163,6,1,3,10
DEFAULT,817,7,0,1,8
DEFAULT,482,3,1,1,5
DEFAULT,1034,5,1,3,9
GREEDY,3266,13,0,1,14
DEFAULT,522,7,2,1,10
DEFAULT,850,6,1,1,8
GREEDY,8070,11,1,3,15
GREEDY,16949,14,1,2,17
GREEDY,17377,13,2,1,16
GREEDY,613,11,0,3,14
GREEDY,5483,15,0,2,17
GREEDY,2722,15,1,2,18
GREEDY,2538,12,1,2,15
GREEDY,6282,10,1,1,12
GREEDY,262,7,1,2,10
DEFAULT,871,8,1,3,12
DEFAULT,76,8,0,1,9
GREEDY,4404,16,0,2,18
DEFAULT,626,4,0,1,5
DEFAULT,19820,9,0,2,11
DEFAULT,3374,7,2,2,11
DEFAULT,792,7,2,2,11
DEFAULT,53309,12,0,3,15
DEFAULT,41650,12,1,2,15
DEFAULT,385,7,1,1,9
GREEDY,11540,15,2,2,19
DEFAULT,426,7,1,0,8
DEFAULT,405,7,1,0,8
DEFAULT,570,3,2,3,8
GREEDY,1233,7,1,4,12
DEFAULT,959,6,0,1,7
DEFAULT,682,12,1,0,13
GREEDY,278,9,1,3,13
DEFAULT,762,6,0,0,6
GREEDY,1394,10,0,3,13
DEFAULT,734,8,2,0,10
GREEDY,617,11,2,3,16
DEFAULT,1344,8,0,3,11
DEFAULT,66,7,0,2,9
DEFAULT,6775,14,0,1,15
DEFAULT,2664,7,2,2,11
DEFAULT,20581,11,0,1,12
GREEDY,3224,17,0,3,20
GREEDY,2216,13,0,4,17
DEFAULT,19236,13,0,3,16
DEFAULT,1160,8,0,0,8
DEFAULT,12900,10,2,2,14
DEFAULT,3024,10,1,3,14
DEFAULT,984,9,1,1,11
GREEDY,7260,13,2,2,17
GREEDY,5476,12,1,3,16
GREEDY,2255,12,0,2,14
GREEDY,2929,16,0,3,19
GREEDY,1037,12,2,2,16
GREEDY,5295,13,1,3,17
DEFAULT,1173,5,1,2,8
DEFAULT,10573,9,2,3,14
GREEDY,3628,11,1,2,14
GREEDY,6065,13,2,3,18
GREEDY,564,7,1,2,10
DEFAULT,684,4,0,1,5
GREEDY,4522,12,1,1,14
DEFAULT,21482,12,2,3,17
DEFAULT,1317,5,1,1,7
DEFAULT,922,2,0,2,4
GREEDY,7180,14,1,2,17
DEFAULT,897,3,0,1,4
GREEDY,59,5,1,3,9
GREEDY,16040,11,1,2,14
DEFAULT,666,5,0,1,6
GREEDY,94,8,0,0,8
GREEDY,33134,13,1,3,17
GREEDY,1270,6,1,0,7
GREEDY,1439,11,0,4,15
GREEDY,10975,8,1,2,11
GREEDY,5437,16,1,2,19
GREEDY,20,7,0,2,9
GREEDY,558,7,1,1,9
DEFAULT,948,8,0,3,11
GREEDY,3729,10,0,2,12
GREEDY,982,8,2,2,12
DEFAULT,966,5,0,0,5
GREEDY,229,7,1,0,8
GREEDY,10161,16,1,1,18
DEFAULT,7148,11,1,3,15
DEFAULT,9442,13,1,2,16
DEFAULT,293,7,0,0,7
GREEDY,5856,13,1,4,18
DEFAULT,230,6,1,1,8
GREEDY,3804,12,1,4,17
GREEDY,3161,11,2,1,14
DEFAULT,190,8,0,1,9
GREEDY,7897,12,0,2,14
GREEDY,1684,13,1,3,17
GREEDY,1252,11,1,2,14
GREEDY,3683,13,1,3,17
DEFAULT,86,8,0,1,9
GREEDY,13162,12,1,2,15
DEFAULT,365,6,0,1,7
GREEDY,4841,14,1,3,18
GREEDY,981,10,1,2,13
DEFAULT,674,9,0,4,13
DEFAULT,19314,12,2,1,15
GREEDY,6381,14,1,1,16
DEFAULT,51322,10,1,3,14
DEFAULT,266,8,0,0,8
DEFAULT,10575,11,0,1,12
GREEDY,3331,11,2,3,16
GREEDY,372,7,1,1,9
DEFAULT,401,8,0,1,9
GREEDY,5107,11,0,4,15
GREEDY,1838,15,1,1,17
DEFAULT,514,6,0,1,7
DEFAULT,1140,5,0,3,8
GREEDY,5128,10,0,3,13
DEFAULT,2715,7,2,4,13
DEFAULT,20836,12,0,1,13
GREEDY,37347,11,1,2,14
DEFAULT,1415,2,0,1,3
GREEDY,1166,11,2,3,16
DEFAULT,1521,8,0,3,11
GREEDY,341,10,1,3,14
GREEDY,543,7,1,1,9
GREEDY,4957,14,1,2,17
DEFAULT,778,5,2,0,7
DEFAULT,121,7,1,3,11
DEFAULT,602,10,0,1,11
GREEDY,6680,14,1,2,17
DEFAULT,511,6,1,1,8
DEFAULT,1617,3,0,0,3
GREEDY,2691,13,2,1,16
GREEDY,854,10,1,0,11
DEFAULT,35315,9,1,2,12
DEFAULT,299,7,0,2,9
GREEDY,2041,12,2,1,15
DEFAULT,15647,13,2,0,15
DEFAULT,9841,12,2,3,17
GREEDY,13248,12,0,1,13
DEFAULT,1731,4,1,0,5
GREEDY,7592,11,1,3,15
GREEDY,5121,13,1,3,17
DEFAULT,1148,5,0,1,6
DEFAULT,942,4,0,1,5
GREEDY,9754,12,1,1,14
GREEDY,8037,15,0,4,19
DEFAULT,17604,9,0,2,11
DEFAULT,851,8,0,0,8
DEFAULT,865,5,2,1,8
DEFAULT,492,7,1,1,9
DEFAULT,837,8,2,1,11
GREEDY,850,11,1,2,14
DEFAULT,662,9,0,3,12
DEFAULT,18283,14,1,2,17
DEFAULT,807,5,0,2,7
DEFAULT,1503,1,1,0,2
GREEDY,4463,14,2,3,19
GREEDY,8575,15,1,1,17
DEFAULT,942,4,2,2,8
GREEDY,4777,11,2,3,16
DEFAULT,16018,11,0,1,12
DEFAULT,1757,5,0,2,7
DEFAULT,2613,11,0,2,13
GREEDY,1308,10,0,4,14
GREEDY,3906,12,2,2,16
DEFAULT,891,5,1,1,7
GREEDY,1576,12,2,3,17
DEFAULT,22715,15,0,1,16
DEFAULT,1418,7,0,2,9
GREEDY,16636,12,2,3,17
GREEDY,1093,8,1,0,9
GREEDY,372,13,1,4,18
DEFAULT,18997,13,0,1,14
GREEDY,1126,12,1,2,15
DEFAULT,837,7,0,0,7
DEFAULT,455,8,1,0,9
GREEDY,1767,14,1,3,18
DEFAULT,1188,2,1,1,4
DEFAULT,680,4,1,3,8
GREEDY,11561,12,1,1,14
GREEDY,8856,15,1,3,19
GREEDY,5232,11,1,4,16
GREEDY,1479,10,2,3,15
GREEDY,9241,14,1,3,18
GREEDY,2888,14,0,1,15
GREEDY,3848,14,1,0,15
GREEDY,408,9,1,0,10
DEFAULT,948,8,1,1,10
GREEDY,501,6,1,4,11
DEFAULT,1233,6,1,2,9
DEFAULT,12277,10,1,2,13
DEFAULT,573,3,2,0,5
DEFAULT,1137,4,0,0,4
DEFAULT,1986,5,1,1,7
GREEDY,1043,12,1,2,15
GREEDY,13500,11,1,2,14
GREEDY,6539,12,2,1,15
DEFAULT,10387,10,2,1,13
GREEDY,335,7,1,3,11
GREEDY,14122,13,1,4,18
DEFAULT,1376,9,0,2,11
DEFAULT,41437,12,0,3,15
GREEDY,1206,12,1,3,16
GREEDY,4978,13,1,3,17
DEFAULT,9973,11,1,2,14
GREEDY,3314,15,2,2,19
DEFAULT,58,7,0,1,8
DEFAULT,10161,13,1,1,15
GREEDY,998,7,2,1,10
GREEDY,2155,14,0,1,15
DEFAULT,2408,7,0,1,8
GREEDY,427,10,1,2,13
DEFAULT,567,6,1,0,7
DEFAULT,810,4,1,0,5
DEFAULT,1276,4,0,1,5
GREEDY,18323,11,1,2,14
GREEDY,649,5,0,1,6
GREEDY,668,11,1,2,14
GREEDY,5343,15,1,2,18
GREEDY,252,6,0,2,8
GREEDY,357,12,1,3,16
DEFAULT,919,6,0,2,8
GREEDY,3775,10,2,4,16
DEFAULT,19191,10,1,2,13
GREEDY,3327,13,0,2,15
GREEDY,295,8,0,3,11
DEFAULT,1233,7,0,1,8
GREEDY,1250,8,2,3,13
DEFAULT,344,5,2,1,8
DEFAULT,1671,9,0,3,12
DEFAULT,65,8,1,2,11
GREEDY,5935,14,0,4,18
GREEDY,3678,15,1,4,20
GREEDY,353,6,1,1,8
GREEDY,126,8,2,2,12
DEFAULT,585,7,0,2,9
DEFAULT,611,9,0,3,12
GREEDY,6597,15,2,2,19
DEFAULT,1276,6,1,2,9
DEFAULT,17019,12,1,2,15
GREEDY,4283,15,1,3,19
GREEDY,420,6,2,3,11
DEFAULT,1960,5,1,3,9
GREEDY,132,9,2,1,12
DEFAULT,1219,7,2,2,11
GREEDY,487,7,0,0,7
GREEDY,316,7,2,0,9
DEFAULT,1442,6,1,0,7
GREEDY,415,8,2,1,11
DEFAULT,991,9,2,2,13
DEFAULT,1365,6,0,2,8
DEFAULT,10496,11,0,2,13
DEFAULT,35901,13,1,2,16
DEFAULT,773,6,1,1,8
DEFAULT,480,9,0,2,11
GREEDY,2406,13,1,2,16
GREEDY,662,8,1,3,12
GREEDY,6093,12,2,2,16
GREEDY,22766,12,1,3,16
DEFAULT,548,6,0,3,9
GREEDY,8242,11,0,2,13
GREEDY,1898,16,1,2,19
DEFAULT,929,5,0,1,6
DEFAULT,1322,4,0,2,6
DEFAULT,287,9,2,1,12
DEFAULT,528,5,0,2,7
GREEDY,943,4,2,2,8
DEFAULT,980,5,0,3,8
DEFAULT,724,3,1,2,6
DEFAULT,161,7,1,3,11
DEFAULT,1438,5,2,1,8
DEFAULT,1120,7,1,1,9
GREEDY,7456,13,1,3,17
DEFAULT,830,5,1,0,6
DEFAULT,212,7,1,2,10
DEFAULT,599,10,0,3,13
GREEDY,1023,14,1,2,17
DEFAULT,171,7,2,2,11
GREEDY,6566,13,0,2,15
DEFAULT,920,4,0,0,4
DEFAULT,1890,10,1,2,13
DEFAULT,812,2,1,1,4
GREEDY,8571,12,1,2,15
DEFAULT,176,8,0,0,8
DEFAULT,490,5,2,2,9
GREEDY,3199,12,1,3,16
GREEDY,10296,13,0,3,16
GREEDY,2261,15,2,3,20
GREEDY,7244,14,2,3,19
GREEDY,1658,10,0,1,11
GREEDY,298,10,1,0,11
DEFAULT,2027,9,1,3,13
DEFAULT,1104,7,1,0,8
DEFAULT,21767,11,1,2,14
GREEDY,2066,13,1,3,17
DEFAULT,677,8,1,2,11
DEFAULT,656,5,2,1,8
GREEDY,37239,12,2,2,16
GREEDY,5519,11,1,3,15
DEFAULT,709,7,2,0,9
GREEDY,1930,12,0,3,15
GREEDY,443,7,1,3,11
GREEDY,6926,11,1,3,15
DEFAULT,170,6,2,2,10
DEFAULT,450,8,1,1,10
GREEDY,3652,13,1,4,18
GREEDY,3835,13,2,1,16
GREEDY,271,8,0,2,10
GREEDY,2735,13,2,4,19
GREEDY,530,9,0,1,10
DEFAULT,59637,9,1,1,11
DEFAULT,3100,9,0,3,12
DEFAULT,248,8,0,1,9
GREEDY,523,12,2,3,17
DEFAULT,1748,3,0,1,4
DEFAULT,624,6,0,2,8
DEFAULT,11506,9,0,1,10
GREEDY,1587,13,0,4,17
DEFAULT,439,5,1,1,7
GREEDY,6199,14,2,2,18
DEFAULT,329,9,1,1,11
GREEDY,3162,12,1,2,15
GREEDY,3637,16,2,3,21
GREEDY,2835,11,0,4,15
DEFAULT,1124,10,0,3,13
GREEDY,19999,12,1,2,15
GREEDY,147,11,0,3,14
DEFAULT,30,9,0,1,10
GREEDY,3181,15,0,2,17
GREEDY,5206,11,1,1,13
GREEDY,586,10,1,3,14
DEFAULT,1616,3,0,3,6
GREEDY,2708,14,0,2,16
GREEDY,221,8,0,2,10
GREEDY,3942,13,1,3,17
DEFAULT,1077,4,1,1,6
DEFAULT,497,7,1,0,8
DEFAULT,702,6,0,3,9
DEFAULT,1041,6,0,2,8
DEFAULT,1191,6,2,2,10
GREEDY,5651,12,1,3,16
DEFAULT,679,6,1,0,7
GREEDY,1824,8,0,3,11
DEFAULT,622,8,0,1,9
GREEDY,5165,10,1,4,15
DEFAULT,783,5,1,1,7
GREEDY,12971,14,0,2,16
DEFAULT,879,6,0,1,7
GREEDY,1332,11,2,2,15
GREEDY,6884,15,1,2,18
DEFAULT,12300,10,2,2,14
GREEDY,1736,9,2,4,15
DEFAULT,1290,5,0,3,8
GREEDY,1072,12,1,2,15
DEFAULT,786,11,1,2,14
DEFAULT,1069,7,0,1,8
GREEDY,1307,15,1,2,18
GREEDY,3967,12,1,3,16
DEFAULT,181,7,1,2,10
DEFAULT,355,10,0,2,12
DEFAULT,8439,10,0,2,12
GREEDY,6994,12,2,3,17
DEFAULT,7556,10,2,2,14
DEFAULT,873,5,1,1,7
DEFAULT,1065,4,1,0,5
GREEDY,22980,15,1,1,17
GREEDY,13658,14,1,3,18
DEFAULT,25503,15,1,1,17
GREEDY,3484,12,1,1,14
GREEDY,645,4,1,1,6
DEFAULT,11211,9,1,4,14
DEFAULT,952,4,0,1,5
DEFAULT,17758,13,1,1,15
GREEDY,3480,12,1,3,16
GREEDY,2541,12,1,2,15
DEFAULT,1535,8,2,2,12
GREEDY,184,9,0,1,10
DEFAULT,1470,3,1,1,5
DEFAULT,5422,14,2,3,19
DEFAULT,17696,12,0,1,13
GREEDY,472,10,2,2,14
GREEDY,1424,10,2,4,16
DEFAULT,951,8,0,2,10
GREEDY,888,9,0,3,12
DEFAULT,2452,10,2,2,14
GREEDY,900,6,1,4,11
GREEDY,3350,12,1,3,16
GREEDY,1252,8,0,4,12
DEFAULT,816,6,0,1,7
DEFAULT,1333,6,1,4,11
GREEDY,1889,11,1,1,13
DEFAULT,1145,10,1,3,14
GREEDY,6836,10,1,2,13
GREEDY,14658,10,2,1,13
DEFAULT,1113,1,1,2,4
GREEDY,5107,13,1,2,16
GREEDY,1038,12,1,3,16
GREEDY,4122,12,1,2,15
DEFAULT,364,7,0,2,9
GREEDY,18260,12,0,3,15
GREEDY,10287,13,2,2,17
DEFAULT,972,11,1,2,14
DEFAULT,702,2,1,2,5
DEFAULT,1257,6,2,2,10
DEFAULT,2453,4,1,4,9
DEFAULT,511,7,2,0,9
GREEDY,3893,14,0,3,17
GREEDY,2738,18,1,2,21
DEFAULT,55625,11,1,3,15
GREEDY,3858,14,1,3,18
GREEDY,2599,14,2,1,17
GREEDY,7325,14,0,3,17
DEFAULT,468,8,1,4,13
GREEDY,885,10,2,1,13
DEFAULT,1097,3,1,1,5
GREEDY,4589,11,1,3,15
DEFAULT,413,7,1,1,9
GREEDY,15942,12,1,3,16
GREEDY,5956,13,2,1,16
GREEDY,5848,12,2,3,17
GREEDY,6733,11,1,3,15
GREEDY,545,7,0,3,10
GREEDY,5633,13,2,3,18
GREEDY,6205,11,1,3,15
GREEDY,910,12,1,3,16
DEFAULT,3534,13,1,2,16
DEFAULT,1800,5,2,2,9
GREEDY,1333,13,0,4,17
GREEDY,5415,12,2,3,17
DEFAULT,472,4,1,1,6
DEFAULT,1008,12,2,2,16
GREEDY,1296,5,0,1,6
DEFAULT,942,6,1,3,10
DEFAULT,847,12,1,3,16
DEFAULT,13152,12,1,2,15
DEFAULT,1815,4,1,0,5
DEFAULT,949,5,0,1,6
DEFAULT,26079,8,1,2,11
DEFAULT,293,10,0,1,11
GREEDY,1878,13,1,4,18
GREEDY,386,6,2,2,10
GREEDY,4246,11,1,3,15
GREEDY,3962,16,1,2,19
GREEDY,84650,13,2,2,17
GREEDY,1071,9,2,3,14
DEFAULT,59563,11,0,2,13
DEFAULT,2080,7,0,3,10
DEFAULT,1140,6,1,1,8
DEFAULT,21509,13,1,2,16
DEFAULT,1853,9,1,0,10
DEFAULT,2037,9,2,4,15
DEFAULT,791,8,0,3,11
DEFAULT,413,5,1,1,7
DEFAULT,295,10,0,0,10
GREEDY,2127,11,1,3,15
DEFAULT,5296,12,1,2,15
GREEDY,2607,12,0,3,15
DEFAULT,1059,7,2,2,11
GREEDY,1383,9,1,4,14
GREEDY,1626,14,1,3,18
DEFAULT,175,7,1,1,9
DEFAULT,17255,11,1,2,14
GREEDY,5119,15,1,2,18
GREEDY,4156,11,2,2,15
GREEDY,316,5,1,2,8
GREEDY,2417,8,2,4,14
DEFAULT,1166,6,0,2,8
GREEDY,527,12,2,3,17
GREEDY,3483,11,0,2,13
GREEDY,7911,12,1,3,16
GREEDY,934,6,2,3,11
GREEDY,3719,15,2,3,20
DEFAULT,822,6,0,1,7
GREEDY,17390,10,0,1,11
GREEDY,7792,12,2,1,15
DEFAULT,18155,17,0,0,17
DEFAULT,4702,10,0,3,13
GREEDY,866,10,2,1,13
DEFAULT,899,5,1,3,9
GREEDY,3899,11,1,2,14
GREEDY,3031,12,2,2,16
GREEDY,4054,12,2,2,16
GREEDY,256,11,1,2,14
GREEDY,52384,13,0,3,16
GREEDY,542,6,0,2,8
GREEDY,4664,11,1,2,14
DEFAULT,9925,11,1,1,13
DEFAULT,1009,3,1,3,7
DEFAULT,752,5,2,3,10
GREEDY,528,10,1,1,12
DEFAULT,1281,3,1,2,6
GREEDY,2651,13,0,2,15
DEFAULT,1064,6,1,0,7
DEFAULT,1257,6,2,0,8
GREEDY,2158,15,1,4,20
DEFAULT,5388,12,1,2,15
GREEDY,357,5,1,2,8
GREEDY,1978,12,1,1,14
GREEDY,160,7,0,2,9
GREEDY,322,10,2,1,13
DEFAULT,358,8,2,2,12
GREEDY,438,7,1,4,12
DEFAULT,1258,3,0,0,3
GREEDY,5551,14,1,2,17
DEFAULT,12405,11,1,2,14
DEFAULT,594,6,0,3,9
GREEDY,4160,14,1,3,18
DEFAULT,1262,8,1,3,12
DEFAULT,336,7,1,2,10
GREEDY,10379,11,1,3,15
DEFAULT,791,11,0,2,13
DEFAULT,979,4,0,0,4
GREEDY,6096,13,1,2,16
GREEDY,1222,10,2,4,16
GREEDY,2731,12,1,3,16
GREEDY,1086,11,2,2,15
DEFAULT,1214,2,0,0,2
DEFAULT,774,11,0,1,12
DEFAULT,787,8,0,3,11
DEFAULT,27356,12,0,1,13
DEFAULT,904,6,0,1,7
DEFAULT,319,5,1,0,6
DEFAULT,950,4,1,1,6
GREEDY,2438,13,0,2,15
GREEDY,5580,11,2,3,16
DEFAULT,1114,4,1,2,7
GREEDY,1606,11,1,3,15
DEFAULT,6122,12,0,2,14
GREEDY,437,5,0,3,8
GREEDY,60,11,0,0,11
DEFAULT,340,10,0,3,13
DEFAULT,1300,5,0,0,5
GREEDY,625,13,2,2,17
DEFAULT,430,7,1,1,9
DEFAULT,608,3,0,2,5
DEFAULT,1403,2,0,2,4
DEFAULT,1031,8,0,2,10
DEFAULT,4344,11,1,0,12
GREEDY,799,11,1,2,14
DEFAULT,711,6,0,2,8
DEFAULT,1565,9,1,3,13
GREEDY,3132,12,1,4,17
GREEDY,11357,10,1,3,14
GREEDY,36939,12,0,3,15
GREEDY,4005,12,1,3,16
DEFAULT,13085,11,1,1,13
DEFAULT,180,6,1,3,10
GREEDY,3763,13,2,3,18
GREEDY,6036,12,1,2,15
GREEDY,24206,14,1,2,17
DEFAULT,8365,12,1,1,14
DEFAULT,79,5,0,2,7
GREEDY,2490,12,1,2,15
GREEDY,143,8,0,1,9
DEFAULT,461,8,0,0,8
GREEDY,14351,12,2,0,14
GREEDY,16361,12,1,2,15
GREEDY,4564,13,2,2,17
GREEDY,7003,12,1,2,15
DEFAULT,222,8,0,1,9
GREEDY,5594,13,0,3,16
GREEDY,16549,12,0,2,14
DEFAULT,994,7,0,0,7
GREEDY,154,10,1,2,13
GREEDY,12385,12,1,3,16
DEFAULT,762,3,2,3,8
DEFAULT,407,8,1,1,10
GREEDY,507,9,1,3,13
DEFAULT,714,6,1,1,8
DEFAULT,812,7,1,3,11
GREEDY,1342,9,2,3,14
DEFAULT,5440,12,2,2,16
DEFAULT,574,6,1,1,8
DEFAULT,932,7,2,2,11
DEFAULT,1078,6,0,0,6
GREEDY,2362,10,1,2,13
GREEDY,2903,11,1,4,16
DEFAULT,702,3,0,1,4
DEFAULT,1001,6,1,2,9
DEFAULT,996,5,1,1,7
GREEDY,632,10,0,2,12
DEFAULT,1246,8,1,1,10
GREEDY,2125,15,1,2,18
DEFAULT,516,9,0,2,11
GREEDY,3520,15,1,3,19
DEFAULT,871,8,0,0,8
GREEDY,12230,11,2,1,14
DEFAULT,385,7,1,4,12
GREEDY,1179,11,2,1,14
DEFAULT,1131,4,1,1,6
GREEDY,4348,12,1,3,16
DEFAULT,10075,11,2,1,14
DEFAULT,989,5,1,2,8
GREEDY,6172,13,2,2,17
DEFAULT,6642,12,1,3,16
DEFAULT,1375,3,0,1,4
DEFAULT,1153,5,0,1,6
GREEDY,8866,13,2,2,17
GREEDY,655,7,1,3,11
DEFAULT,14723,10,1,3,14
GREEDY,225,7,1,2,10
DEFAULT,1172,7,0,0,7
GREEDY,296,6,1,2,9
GREEDY,246,9,1,2,12
GREEDY,356,8,0,3,11
DEFAULT,542,11,1,1,13
DEFAULT,432,7,2,1,10
GREEDY,11949,13,2,3,18
DEFAULT,516,8,0,2,10
DEFAULT,983,2,1,2,5
GREEDY,4387,12,1,3,16
DEFAULT,743,8,0,2,10
GREEDY,11071,12,1,2,15
GREEDY,1076,8,0,2,10
DEFAULT,716,7,0,1,8
DEFAULT,837,8,0,3,11
GREEDY,8451,10,1,2,13
DEFAULT,2258,7,1,3,11
GREEDY,13825,12,0,2,14
GREEDY,3010,12,1,3,16
DEFAULT,465,9,1,0,10
GREEDY,3516,11,2,1,14
DEFAULT,1652,1,0,3,4
GREEDY,6028,12,1,2,15
GREEDY,2251,10,1,3,14
GREEDY,421,7,2,2,11
DEFAULT,82584,9,0,3,12
DEFAULT,801,6,0,1,7
GREEDY,5620,11,2,3,16
DEFAULT,902,4,0,1,5
DEFAULT,1489,8,1,3,12
GREEDY,2901,13,0,3,16
GREEDY,2609,12,2,2,16
DEFAULT,119,10,1,1,12
DEFAULT,246,7,1,1,9
DEFAULT,25464,13,1,3,17
GREEDY,12089,16,1,1,18
GREEDY,9637,14,2,3,19
DEFAULT,1686,6,1,1,8
DEFAULT,689,6,2,0,8
DEFAULT,893,5,1,0,6
GREEDY,2769,12,1,3,16
DEFAULT,655,5,1,2,8
DEFAULT,831,5,0,1,6
DEFAULT,799,3,0,1,4
DEFAULT,925,5,1,1,7
DEFAULT,676,8,2,2,12
DEFAULT,1331,4,1,4,9
GREEDY,405,10,1,0,11
DEFAULT,470,4,0,0,4
DEFAULT,52,8,2,0,10
GREEDY,1191,11,2,3,16
DEFAULT,404,6,1,2,9
DEFAULT,829,7,1,3,11
DEFAULT,75824,11,0,1,12
GREEDY,6220,13,1,2,16
DEFAULT,350,6,1,1,8
DEFAULT,410,5,1,0,6
DEFAULT,17563,11,0,2,13
DEFAULT,462,6,0,1,7
DEFAULT,791,4,1,0,5
GREEDY,394,6,1,2,9
DEFAULT,951,5,0,1,6
GREEDY,5645,12,1,2,15
GREEDY,551,9,0,0,9
DEFAULT,953,6,1,2,9
GREEDY,6774,11,2,3,16
DEFAULT,781,5,0,0,5
DEFAULT,1680,7,0,3,10
DEFAULT,1336,9,1,3,13
DEFAULT,741,6,0,1,7
DEFAULT,390,3,1,2,6
GREEDY,2483,11,2,3,16
DEFAULT,43534,10,1,3,14
DEFAULT,21611,8,2,2,12
GREEDY,4370,14,2,2,18
GREEDY,2846,12,1,2,15
DEFAULT,771,10,1,1,12
DEFAULT,710,5,0,2,7
DEFAULT,1001,3,0,0,3
DEFAULT,456,8,1,3,12
GREEDY,364,7,1,3,11
DEFAULT,25239,15,1,2,18
GREEDY,245,6,1,0,7
DEFAULT,732,6,1,0,7
DEFAULT,634,5,1,1,7
GREEDY,3273,12,0,4,16
DEFAULT,836,5,1,2,8
GREEDY,8250,15,2,3,20
DEFAULT,812,7,0,2,9
GREEDY,243,9,1,4,14
GREEDY,7163,12,1,2,15
GREEDY,607,4,1,3,8
DEFAULT,292,7,2,0,9
DEFAULT,1280,7,1,1,9
DEFAULT,148,7,1,3,11
DEFAULT,1238,4,1,1,6
DEFAULT,24728,14,1,3,18
DEFAULT,400,6,0,3,9
GREEDY,1340,14,0,2,16
DEFAULT,16924,10,1,1,12
GREEDY,801,8,2,1,11
GREEDY,6295,12,1,1,14
DEFAULT,885,5,1,0,6
DEFAULT,449,7,2,1,10
DEFAULT,672,7,0,4,11
GREEDY,2400,14,0,3,17
GREEDY,4966,13,1,3,17
GREEDY,5100,12,1,3,16
DEFAULT,585,7,0,2,9
DEFAULT,905,2,1,1,4
GREEDY,777,3,1,1,5
DEFAULT,2048,5,0,3,8
GREEDY,857,10,2,3,15
DEFAULT,37672,12,0,1,13
GREEDY,473,11,0,3,14
DEFAULT,661,7,0,2,9
GREEDY,2939,13,0,4,17
DEFAULT,1477,8,0,3,11
GREEDY,7377,12,1,4,17
DEFAULT,909,6,0,0,6
DEFAULT,745,6,0,2,8
GREEDY,7106,16,1,1,18
GREEDY,1552,15,2,1,18
GREEDY,8689,15,2,2,19
GREEDY,1410,9,2,3,14
DEFAULT,16589,14,1,1,16
DEFAULT,652,8,0,2,10
DEFAULT,47767,12,1,2,15
GREEDY,2392,13,1,2,16
GREEDY,12868,12,2,3,17
GREEDY,3574,13,1,1,15
GREEDY,896,10,1,1,12
DEFAULT,528,5,1,1,7
DEFAULT,641,8,0,2,10
DEFAULT,1351,8,2,3,13
GREEDY,3340,15,0,3,18
DEFAULT,512,7,2,2,11
DEFAULT,4620,13,0,2,15
DEFAULT,82058,12,1,2,15
GREEDY,3347,17,1,1,19
GREEDY,250,7,1,2,10
GREEDY,466,10,0,2,12
DEFAULT,666,6,1,0,7
DEFAULT,2095,10,1,3,14
DEFAULT,1127,5,0,2,7
GREEDY,7630,11,1,3,15
GREEDY,803,9,1,3,13
DEFAULT,10351,11,0,2,13
GREEDY,2407,15,1,1,17
GREEDY,13845,13,1,3,17
DEFAULT,197,4,1,2,7
GREEDY,582,13,0,1,14
DEFAULT,16000,13,1,1,15
DEFAULT,1361,2,0,1,3
GREEDY,5956,16,0,0,16
DEFAULT,629,7,1,0,8
DEFAULT,481,8,0,1,9
DEFAULT,7544,11,0,1,12
DEFAULT,30308,14,0,3,17
DEFAULT,699,8,1,3,12
DEFAULT,685,7,0,1,8
GREEDY,5081,13,1,2,16
DEFAULT,834,4,1,0,5
DEFAULT,875,8,2,2,12
DEFAULT,285,7,0,3,10
GREEDY,2327,14,1,2,17
GREEDY,8201,15,2,1,18
GREEDY,354,10,0,0,10
DEFAULT,1424,4,0,0,4
DEFAULT,1343,4,1,1,6
DEFAULT,631,8,2,0,10
GREEDY,11381,11,2,4,17
GREEDY,3698,16,2,4,22
DEFAULT,12437,11,0,2,13
DEFAULT,638,6,1,2,9
DEFAULT,2831,8,1,2,11
GREEDY,86,6,1,1,8
DEFAULT,673,5,0,1,6
DEFAULT,9775,7,1,3,11
DEFAULT,1052,5,0,1,6
DEFAULT,417,6,1,0,7
GREEDY,486,7,1,2,10
DEFAULT,1957,7,2,1,10
DEFAULT,11348,9,1,2,12
GREEDY,805,7,1,3,11
DEFAULT,1612,4,0,2,6
DEFAULT,1404,3,0,0,3
GREEDY,5968,11,2,1,14
DEFAULT,626,4,1,1,6
GREEDY,5469,13,2,3,18
GREEDY,3136,15,0,2,17
GREEDY,3232,12,1,2,15
DEFAULT,17041,10,2,2,14
GREEDY,619,9,1,2,12
GREEDY,286,9,2,2,13
DEFAULT,1162,3,0,1,4
DEFAULT,959,7,1,0,8
GREEDY,11350,14,1,3,18
DEFAULT,1078,7,1,4,12
DEFAULT,413,6,1,1,8
DEFAULT,967,5,1,1,7
GREEDY,739,8,0,3,11
DEFAULT,7014,10,1,2,13
GREEDY,2688,14,1,4,19
GREEDY,498,10,0,3,13
GREEDY,3383,11,2,2,15
GREEDY,19620,13,0,3,16
GREEDY,7853,12,0,3,15
GREEDY,3979,15,1,2,18
DEFAULT,1498,6,2,2,10
DEFAULT,1152,11,0,1,12
DEFAULT,365,8,0,2,10
DEFAULT,1986,4,0,4,8
DEFAULT,401,6,1,0,7
DEFAULT,389,11,0,1,12
GREEDY,32243,10,0,2,12
DEFAULT,1341,4,1,0,5
GREEDY,24977,12,1,1,14
GREEDY,44,8,0,2,10
DEFAULT,1949,10,2,2,14
GREEDY,870,4,0,1,5
DEFAULT,1677,8,0,2,10
DEFAULT,1969,6,1,2,9
DEFAULT,306,6,2,0,8
GREEDY,19929,13,0,2,15
DEFAULT,454,7,1,3,11
GREEDY,3904,11,2,1,14
DEFAULT,1447,11,1,1,13
GREEDY,7660,16,0,2,18
DEFAULT,584,6,2,3,11
DEFAULT,306,8,0,1,9
DEFAULT,1239,7,1,1,9
GREEDY,7218,12,0,3,15
GREEDY,6080,11,2,4,17
DEFAULT,1009,3,0,1,4
GREEDY,361,5,0,3,8
GREEDY,1214,8,1,4,13
GREEDY,7185,11,2,0,13
DEFAULT,959,6,1,2,9
GREEDY,2417,10,1,4,15
GREEDY,8869,12,2,1,15
GREEDY,2856,9,1,4,14
DEFAULT,444,5,2,1,8
DEFAULT,716,12,1,1,14
DEFAULT,696,5,0,0,5
GREEDY,4799,10,1,0,11
GREEDY,2201,8,1,3,12
DEFAULT,646,7,0,2,9
DEFAULT,675,4,0,1,5
DEFAULT,434,7,1,2,10
GREEDY,7774,12,1,3,16
DEFAULT,1313,6,0,1,7
GREEDY,5467,12,1,3,16
DEFAULT,160,6,0,1,7
DEFAULT,1219,7,1,0,8
DEFAULT,9495,11,0,3,14
DEFAULT,635,7,1,3,11
GREEDY,3169,14,0,2,16
DEFAULT,1081,4,1,3,8
DEFAULT,1122,7,1,0,8
DEFAULT,792,7,0,2,9
GREEDY,11698,14,0,1,15
DEFAULT,755,3,0,3,6
DEFAULT,425,6,0,2,8
DEFAULT,1032,8,1,1,10
DEFAULT,760,10,1,2,13
DEFAULT,870,4,0,2,6
GREEDY,601,8,2,3,13
DEFAULT,339,5,1,3,9
DEFAULT,403,5,1,1,7
GREEDY,7107,13,2,2,17
GREEDY,558,10,1,4,15
DEFAULT,410,5,1,2,8
GREEDY,409,9,1,3,13
GREEDY,496,8,1,3,12
DEFAULT,16515,13,0,2,15
DEFAULT,3252,10,1,2,13
DEFAULT,859,5,1,1,7
DEFAULT,926,4,0,2,6
GREEDY,2383,12,1,3,16
DEFAULT,886,4,0,0,4
GREEDY,4719,12,1,3,16
DEFAULT,957,6,2,2,10
GREEDY,3843,13,1,2,16
DEFAULT,666,5,2,2,9
DEFAULT,2154,8,0,3,11
GREEDY,275,7,2,1,10
DEFAULT,937,6,0,1,7
DEFAULT,468,7,0,2,9
GREEDY,4354,14,1,2,17
DEFAULT,578,9,1,3,13
DEFAULT,1682,7,0,4,11
GREEDY,734,9,2,3,14
DEFAULT,1377,7,1,0,8
GREEDY,1611,9,2,3,14
GREEDY,2711,12,2,4,18
GREEDY,4038,14,1,3,18
GREEDY,4466,12,1,2,15
DEFAULT,546,9,1,0,10
GREEDY,2905,14,1,2,17
GREEDY,408,10,1,1,12
DEFAULT,14000,10,1,2,13
DEFAULT,644,7,0,2,9
GREEDY,567,8,1,1,10
GREEDY,3634,12,2,3,17
DEFAULT,9102,12,1,1,14
GREEDY,1878,12,1,2,15
GREEDY,1564,10,1,3,14
GREEDY,743,9,2,1,12
DEFAULT,491,4,1,2,7
GREEDY,2013,11,1,3,15
DEFAULT,249,11,1,3,15
GREEDY,4682,13,1,4,18
DEFAULT,18426,11,0,2,13
GREEDY,96842,13,2,2,17
DEFAULT,390,7,0,1,8
DEFAULT,191,6,1,1,8
DEFAULT,27941,9,1,2,12
GREEDY,3537,14,2,2,18
GREEDY,4130,10,2,2,14
DEFAULT,477,9,0,1,10
GREEDY,2310,12,0,2,14
GREEDY,1381,14,2,4,20
DEFAULT,1598,2,2,0,4
GREEDY,2885,11,2,3,16
GREEDY,588,8,1,4,13
DEFAULT,4376,9,1,1,11
DEFAULT,556,4,1,1,6
GREEDY,1854,8,2,1,11
DEFAULT,191,12,1,1,14
DEFAULT,1077,4,2,0,6
GREEDY,2587,9,2,4,15
DEFAULT,1308,9,0,3,12
DEFAULT,1217,6,0,3,9
GREEDY,367,7,0,2,9
GREEDY,485,6,0,3,9
DEFAULT,558,10,1,2,13
DEFAULT,334,5,0,1,6
DEFAULT,525,5,0,1,6
GREEDY,3951,12,2,3,17
GREEDY,7103,14,1,3,18
GREEDY,2829,13,0,3,16
DEFAULT,8242,11,0,1,12
GREEDY,3778,14,2,4,20
GREEDY,6077,14,1,3,18
DEFAULT,602,6,1,0,7
GREEDY,10917,14,1,3,18
GREEDY,344,5,0,4,9
DEFAULT,1000,5,0,1,6
GREEDY,494,7,2,4,13
DEFAULT,1361,3,0,0,3
DEFAULT,803,4,0,2,6
GREEDY,4931,12,2,2,16
DEFAULT,126,8,2,1,11
DEFAULT,613,5,2,3,10
DEFAULT,458,7,2,2,11
DEFAULT,190,6,1,3,10
DEFAULT,1226,4,0,0,4
GREEDY,1547,13,1,0,14
GREEDY,285,7,2,2,11
DEFAULT,993,9,0,1,10
GREEDY,608,7,0,0,7
DEFAULT,381,10,0,0,10
DEFAULT,24846,10,0,3,13
DEFAULT,995,12,0,2,14
GREEDY,11621,15,1,3,19
GREEDY,1620,12,1,3,16
GREEDY,1314,8,0,4,12
DEFAULT,474,5,1,0,6
DEFAULT,1282,3,1,3,7
DEFAULT,482,8,1,1,10
GREEDY,697,10,1,3,14
DEFAULT,765,3,1,1,5
GREEDY,1677,8,0,3,11
DEFAULT,328,3,1,1,5
GREEDY,2201,13,1,3,17
GREEDY,23329,14,1,2,17
GREEDY,1743,9,1,2,12
GREEDY,13498,13,1,4,18
GREEDY,627,6,1,3,10
DEFAULT,18890,11,2,1,14
GREEDY,59030,12,0,2,14
GREEDY,763,9,2,2,13
DEFAULT,7301,8,1,3,12
GREEDY,4158,10,1,4,15
DEFAULT,1399,4,1,2,7
GREEDY,682,8,2,2,12
GREEDY,5184,12,2,2,16
GREEDY,14778,14,1,2,17
DEFAULT,462,5,1,0,6
DEFAULT,41181,14,2,1,17
DEFAULT,599,7,0,2,9
GREEDY,5410,14,0,2,16
DEFAULT,1050,5,0,2,7
GREEDY,160,9,0,2,11
DEFAULT,956,6,0,0,6
GREEDY,4722,13,2,2,17
GREEDY,2087,12,2,1,15
DEFAULT,890,6,1,0,7
GREEDY,552,6,2,1,9
GREEDY,3691,12,1,4,17
DEFAULT,3429,7,1,4,12
DEFAULT,962,6,1,3,10
DEFAULT,47060,11,1,2,14
GREEDY,19305,11,1,1,13
GREEDY,2293,14,2,4,20
GREEDY,199,7,0,3,10
GREEDY,9732,14,2,2,18
GREEDY,4499,14,1,3,18
DEFAULT,20529,10,1,2,13
DEFAULT,478,6,1,1,8
GREEDY,2304,16,0,3,19
DEFAULT,452,10,1,0,11
GREEDY,1489,8,1,2,11
DEFAULT,450,6,0,2,8
DEFAULT,1848,9,0,3,12
GREEDY,3298,16,1,2,19
DEFAULT,859,4,0,1,5
GREEDY,3050,12,1,1,14
GREEDY,1113,9,2,3,14
DEFAULT,806,7,0,2,9
GREEDY,1214,8,0,3,11
DEFAULT,1063,6,0,1,7
GREEDY,3595,13,1,1,15
DEFAULT,758,5,1,2,8
DEFAULT,1258,6,0,1,7
DEFAULT,18001,12,1,1,14
GREEDY,360,8,0,2,10
DEFAULT,833,4,1,1,6
GREEDY,70743,11,2,2,15
DEFAULT,778,5,1,1,7
DEFAULT,900,3,1,1,5
DEFAULT,581,8,0,1,9
GREEDY,1149,12,1,3,16
DEFAULT,834,5,0,0,5
DEFAULT,24641,9,1,1,11
DEFAULT,22736,12,0,2,14
DEFAULT,20386,11,1,1,13
GREEDY,4302,12,2,2,16
GREEDY,1682,9,2,4,15
GREEDY,1087,10,2,2,14
DEFAULT,2993,11,1,2,14
DEFAULT,15049,12,0,1,13
GREEDY,530,4,0,3,7
DEFAULT,1069,13,0,2,15
DEFAULT,594,9,0,0,9
DEFAULT,862,6,0,2,8
GREEDY,971,10,2,2,14
GREEDY,4691,13,1,4,18
GREEDY,8911,15,2,3,20
DEFAULT,1307,2,1,1,4
GREEDY,680,10,2,2,14
GREEDY,344,7,1,2,10
DEFAULT,103,9,1,1,11
GREEDY,2385,11,1,4,16
GREEDY,3318,14,1,2,17
GREEDY,3199,10,2,1,13
GREEDY,16562,14,1,1,16
GREEDY,426,14,0,4,18
DEFAULT,258,4,2,1,7
GREEDY,75,7,2,2,11
GREEDY,1915,12,0,3,15
DEFAULT,1329,7,1,1,9
GREEDY,302,8,1,2,11
GREEDY,11098,14,2,3,19
DEFAULT,328,9,1,2,12
DEFAULT,754,7,0,1,8
DEFAULT,1065,8,0,2,10
GREEDY,66884,12,1,1,14
GREEDY,451,9,2,1,12
GREEDY,481,8,2,4,14
DEFAULT,1739,1,2,2,5
GREEDY,3570,13,2,2,17
GREEDY,7332,15,0,1,16
DEFAULT,1097,5,0,1,6
DEFAULT,1122,11,0,2,13
DEFAULT,17957,10,1,4,15
GREEDY,1946,9,2,1,12
GREEDY,5240,12,1,3,16
DEFAULT,848,5,0,1,6
GREEDY,9892,14,1,2,17
GREEDY,4655,14,2,2,18
DEFAULT,14393,12,1,3,16
GREEDY,2896,14,0,3,17
GREEDY,2431,12,1,3,16
DEFAULT,1554,10,0,3,13
GREEDY,1482,11,2,2,15
DEFAULT,1839,6,1,3,10
GREEDY,819,15,1,2,18
