strategy,money,countries,utilities,stations,totalLandsOwned
STINGY,1487,2,0,1,3
STINGY,1373,5,1,1,7
GREEDY,1162,12,1,1,14
GREEDY,6097,16,1,3,20
GREEDY,1140,13,1,1,15
GREEDY,6550,15,2,4,21
GREEDY,3768,19,2,4,25
GREEDY,2292,16,2,4,22
GREEDY,899,12,2,3,17
GREEDY,2336,20,1,3,24
GREEDY,6928,18,2,3,23
GREEDY,7229,16,2,2,20
GREEDY,3779,16,1,2,19
STINGY,1188,3,1,2,6
GREEDY,3808,14,1,4,19
GREEDY,6721,17,2,3,22
STINGY,1379,3,0,1,4
GREEDY,9060,14,2,3,19
GREEDY,4510,18,1,4,23
GREEDY,3530,17,2,3,22
STINGY,1280,3,1,0,4
STINGY,1253,4,0,2,6
GREEDY,4972,16,2,3,21
GREEDY,1440,15,2,3,20
GREEDY,5121,15,2,3,20
STINGY,949,6,0,2,8
GREEDY,3167,14,2,4,20
GREEDY,5377,16,1,2,19
GREEDY,3233,17,2,3,22
GREEDY,3446,15,2,4,21
GREEDY,3419,17,2,2,21
STINGY,995,4,0,1,5
STINGY,1238,2,0,1,3
GREEDY,6498,12,1,4,17
STINGY,647,4,0,0,4
GREEDY,1322,12,2,4,18
GREEDY,7679,16,2,2,20
GREEDY,4167,16,2,2,20
STINGY,809,6,0,0,6
GREEDY,1587,14,2,2,18
GREEDY,1484,12,2,4,18
GREEDY,2831,13,0,1,14
GREEDY,2666,17,1,3,21
STINGY,1245,2,0,0,2
STINGY,1596,1,1,0,2
GREEDY,8165,17,2,3,22
GREEDY,5137,15,2,4,21
GREEDY,3219,18,2,4,24
GREEDY,1742,16,2,3,21
GREEDY,4414,16,2,3,21
GREEDY,4518,19,1,3,23
STINGY,1998,1,0,0,1
GREEDY,3230,19,2,2,23
STINGY,1424,2,0,0,2
STINGY,2131,2,0,1,3
GREEDY,3787,18,2,3,23
GREEDY,3219,16,2,2,20
GREEDY,2074,15,2,4,21
GREEDY,3311,14,1,4,19
STINGY,546,6,0,0,6
GREEDY,5138,18,2,2,22
STINGY,1130,3,1,0,4
GREEDY,3867,15,2,4,21
GREEDY,2069,14,2,3,19
GREEDY,5993,14,2,2,18
STINGY,1198,2,0,0,2
GREEDY,1020,12,1,3,16
GREEDY,2440,15,2,3,20
GREEDY,7130,15,2,3,20
GREEDY,3218,13,1,2,16
STINGY,1189,1,0,1,2
STINGY,1240,2,0,1,3
STINGY,1581,4,0,0,4
GREEDY,3138,14,2,4,20
GREEDY,1876,16,1,4,21
STINGY,1604,2,0,2,4
GREEDY,3659,16,2,2,20
GREEDY,3952,15,1,2,18
GREEDY,10378,15,1,3,19
STINGY,1319,3,0,2,5
GREEDY,14045,14,2,1,17
GREEDY,4518,16,2,2,20
GREEDY,2195,17,2,3,22
STINGY,1574,5,0,1,6
STINGY,1272,1,0,0,1
GREEDY,5632,16,2,3,21
GREEDY,2517,14,0,4,18
STINGY,1657,2,0,0,2
GREEDY,2738,18,2,3,23
STINGY,1282,3,0,0,3
GREEDY,2533,18,1,3,22
GREEDY,3517,15,2,4,21
STINGY,1806,1,0,2,3
STINGY,1504,1,0,0,1
STINGY,1853,2,0,1,3
GREEDY,3270,17,2,2,21
STINGY,1564,3,0,0,3
STINGY,379,4,1,1,6
GREEDY,7496,13,2,3,18
GREEDY,10507,14,2,3,19
STINGY,1561,5,0,0,5
GREEDY,8469,14,0,3,17
GREEDY,1780,15,1,3,19
GREEDY,4337,13,1,3,17
GREEDY,2765,15,1,4,20
STINGY,1572,4,0,1,5
GREEDY,3831,19,1,3,23
STINGY,1858,2,0,0,2
STINGY,1243,2,0,1,3
GREEDY,1624,16,2,4,22
GREEDY,3355,16,2,3,21
GREEDY,2315,16,2,3,21
GREEDY,3993,17,2,2,21
GREEDY,3244,18,2,4,24
STINGY,1860,2,0,2,4
GREEDY,3923,15,2,3,20
GREEDY,2481,11,1,3,15
GREEDY,6131,14,2,2,18
STINGY,1021,3,1,1,5
STINGY,2069,0,0,0,0
STINGY,1057,4,0,0,4
STINGY,2026,4,0,1,5
GREEDY,1904,18,2,2,22
STINGY,1588,5,0,1,6
STINGY,1111,3,0,0,3
GREEDY,4105,19,2,4,25
GREEDY,1858,17,1,3,21
GREEDY,5368,17,2,3,22
GREEDY,2569,14,2,2,18
GREEDY,3782,11,2,4,17
STINGY,899,5,0,1,6
GREEDY,1722,15,2,2,19
GREEDY,5076,15,2,4,21
STINGY,1506,3,0,1,4
STINGY,1112,4,1,0,5
GREEDY,5008,17,1,3,21
GREEDY,2797,14,1,3,18
STINGY,1645,3,1,1,5
GREEDY,443,9,2,3,14
STINGY,943,4,0,1,5
STINGY,1826,1,0,1,2
GREEDY,3610,13,2,3,18
GREEDY,4621,14,1,4,19
GREEDY,5757,17,2,3,22
GREEDY,4147,15,2,4,21
STINGY,1517,8,1,0,9
GREEDY,2674,14,2,2,18
STINGY,1330,2,0,1,3
GREEDY,2419,13,1,4,18
GREEDY,4628,15,2,4,21
GREEDY,1696,13,2,4,19
STINGY,1309,3,0,1,4
GREEDY,2510,14,1,3,18
GREEDY,410,6,0,4,10
GREEDY,2694,15,2,3,20
GREEDY,9399,16,2,3,21
STINGY,2156,3,1,2,6
GREEDY,10427,12,1,4,17
GREEDY,10623,15,2,1,18
STINGY,1668,4,0,2,6
STINGY,1499,5,1,1,7
GREEDY,6220,17,2,3,22
STINGY,1922,6,2,1,9
GREEDY,9443,16,2,3,21
GREEDY,4951,16,2,3,21
GREEDY,10751,15,2,3,20
STINGY,1670,2,0,2,4
STINGY,1150,2,0,0,2
STINGY,1104,4,0,2,6
STINGY,1703,1,0,0,1
GREEDY,1164,16,1,4,21
STINGY,1530,4,1,2,7
GREEDY,4002,16,1,3,20
STINGY,1286,3,0,0,3
GREEDY,4952,14,1,3,18
GREEDY,3742,16,2,4,22
GREEDY,1949,18,1,2,21
GREEDY,2761,16,1,3,20
STINGY,1043,3,0,0,3
STINGY,1594,3,0,2,5
STINGY,1836,3,0,0,3
GREEDY,2032,14,1,4,19
GREEDY,3435,14,0,2,16
GREEDY,2016,15,2,2,19
GREEDY,1464,17,0,4,21
GREEDY,12674,16,2,2,20
GREEDY,3572,17,2,4,23
STINGY,1090,0,1,1,2
STINGY,1098,3,0,1,4
STINGY,1106,4,0,1,5
STINGY,2501,1,0,0,1
GREEDY,2072,15,2,3,20
GREEDY,5516,14,2,4,20
STINGY,1686,2,0,1,3
GREEDY,1265,12,2,3,17
STINGY,756,4,0,0,4
STINGY,1850,1,0,0,1
GREEDY,4533,16,2,3,21
STINGY,1666,3,0,0,3
GREEDY,3831,14,2,3,19
GREEDY,2587,16,2,3,21
STINGY,1497,3,0,0,3
GREEDY,5946,15,2,2,19
GREEDY,7547,14,2,3,19
STINGY,590,6,1,0,7
GREEDY,6053,16,2,2,20
GREEDY,2384,15,2,2,19
STINGY,2891,1,1,0,2
GREEDY,3744,14,1,1,16
GREEDY,707,10,1,4,15
GREEDY,3378,16,1,2,19
STINGY,704,7,0,1,8
GREEDY,10614,15,1,3,19
GREEDY,12305,14,2,3,19
GREEDY,5055,16,1,3,20
STINGY,952,3,0,0,3
GREEDY,3153,15,1,4,20
GREEDY,1046,11,2,3,16
STINGY,1085,6,0,1,7
STINGY,999,7,0,0,7
GREEDY,4954,18,2,2,22
GREEDY,6175,15,1,1,17
GREEDY,4812,13,2,2,17
GREEDY,3457,16,1,3,20
STINGY,922,3,0,2,5
GREEDY,3555,15,1,3,19
STINGY,1613,2,1,0,3
STINGY,967,5,0,0,5
STINGY,1368,5,0,1,6
STINGY,1042,4,0,0,4
STINGY,1746,4,1,1,6
STINGY,1202,4,0,0,4
STINGY,2325,5,0,1,6
STINGY,1332,4,0,1,5
GREEDY,1853,18,2,3,23
STINGY,1842,4,0,1,5
GREEDY,7470,16,2,4,22
STINGY,1310,3,0,0,3
GREEDY,6003,17,2,3,22
STINGY,1274,5,0,1,6
STINGY,1495,3,1,1,5
STINGY,1397,0,0,0,0
STINGY,1198,4,0,0,4
STINGY,1618,1,0,0,1
GREEDY,3479,16,2,2,20
STINGY,1474,4,0,1,5
GREEDY,6196,16,2,2,20
GREEDY,2352,18,2,4,24
STINGY,1830,3,0,0,3
STINGY,1498,1,1,0,2
GREEDY,1588,14,1,2,17
STINGY,1231,5,1,1,7
GREEDY,4438,14,1,4,19
GREEDY,4077,16,0,3,19
STINGY,2107,4,0,2,6
GREEDY,3802,15,1,3,19
GREEDY,5974,18,1,3,22
GREEDY,6411,17,1,3,21
STINGY,2343,6,1,2,9
STINGY,1890,1,0,0,1
GREEDY,3587,12,2,2,16
STINGY,1813,2,0,1,3
GREEDY,4682,18,1,2,21
GREEDY,4485,15,1,2,18
GREEDY,2066,19,2,2,23
GREEDY,4605,17,1,3,21
GREEDY,5869,17,2,3,22
GREEDY,2391,17,1,3,21
STINGY,1914,3,1,2,6
STINGY,1320,1,0,2,3
GREEDY,1737,13,2,4,19
GREEDY,6379,17,2,4,23
GREEDY,3786,17,2,3,22
GREEDY,3300,17,2,3,22
STINGY,1064,6,0,0,6
STINGY,1509,4,0,1,5
STINGY,945,4,0,1,5
GREEDY,3006,19,1,2,22
GREEDY,4517,16,2,3,21
GREEDY,6300,17,1,3,21
GREEDY,1769,13,1,4,18
STINGY,3526,2,0,4,6
GREEDY,1874,15,2,4,21
STINGY,2335,3,0,1,4
GREEDY,5343,17,1,4,22
STINGY,1172,5,0,0,5
GREEDY,4801,18,0,3,21
GREEDY,2378,16,1,4,21
GREEDY,1901,15,1,4,20
GREEDY,3401,17,2,3,22
GREEDY,3500,14,1,4,19
GREEDY,5107,16,2,2,20
GREEDY,5227,14,1,2,17
GREEDY,1676,15,2,3,20
GREEDY,5364,14,2,3,19
STINGY,1335,2,0,2,4
GREEDY,4744,15,2,3,20
GREEDY,3083,19,1,4,24
STINGY,2454,3,1,2,6
GREEDY,4874,13,2,3,18
GREEDY,6696,16,2,3,21
GREEDY,3679,16,1,2,19
GREEDY,2195,17,2,1,20
STINGY,896,4,0,1,5
STINGY,1098,4,0,1,5
GREEDY,8985,17,1,3,21
STINGY,1799,1,0,0,1
GREEDY,9933,16,1,3,20
STINGY,1956,4,0,0,4
STINGY,1644,3,1,1,5
GREEDY,1953,16,2,2,20
GREEDY,3007,15,2,2,19
GREEDY,1984,14,1,2,17
GREEDY,1252,15,1,4,20
STINGY,1786,0,0,0,0
GREEDY,2766,17,2,3,22
GREEDY,479,10,2,3,15
GREEDY,8362,14,2,2,18
GREEDY,5141,14,2,3,19
GREEDY,4102,16,2,1,19
GREEDY,4578,17,1,4,22
GREEDY,4252,18,0,2,20
GREEDY,4274,17,2,4,23
GREEDY,3077,20,1,4,25
STINGY,1320,1,1,0,2
STINGY,1987,0,0,0,0
GREEDY,4286,16,1,4,21
STINGY,1947,3,1,0,4
GREEDY,2551,17,2,4,23
GREEDY,3340,18,2,2,22
STINGY,2746,2,1,2,5
GREEDY,2655,16,2,2,20
STINGY,1395,3,1,0,4
STINGY,1523,3,0,0,3
GREEDY,4781,15,1,3,19
GREEDY,1128,8,2,3,13
STINGY,1318,0,0,2,2
STINGY,2043,2,0,0,2
GREEDY,3286,15,1,4,20
GREEDY,2107,14,1,4,19
GREEDY,3349,14,1,2,17
GREEDY,3289,16,0,4,20
GREEDY,5935,17,2,3,22
GREEDY,2013,17,2,3,22
GREEDY,5700,17,2,3,22
STINGY,1282,4,0,0,4
STINGY,1544,2,1,0,3
STINGY,2017,7,1,2,10
STINGY,1104,4,0,1,5
GREEDY,9212,17,1,3,21
GREEDY,4224,14,1,3,18
GREEDY,1393,18,0,3,21
GREEDY,2148,16,2,3,21
STINGY,1446,0,0,1,1
STINGY,1472,1,0,1,2
GREEDY,1571,15,1,3,19
GREEDY,2143,15,2,4,21
GREEDY,3159,14,1,3,18
GREEDY,2414,20,2,2,24
GREEDY,3078,13,1,4,18
GREEDY,2901,15,2,2,19
STINGY,1438,1,0,1,2
GREEDY,6156,16,2,2,20
GREEDY,4831,15,2,3,20
GREEDY,2175,15,2,4,21
STINGY,981,1,1,1,3
GREEDY,2235,12,2,3,17
GREEDY,3072,16,2,4,22
STINGY,1467,3,0,0,3
GREEDY,1863,18,0,4,22
STINGY,1626,3,0,1,4
GREEDY,2407,18,2,3,23
STINGY,1517,2,0,0,2
GREEDY,4247,16,1,3,20
GREEDY,2660,18,2,0,20
STINGY,2033,4,0,1,5
GREEDY,3941,15,1,3,19
STINGY,1313,2,0,1,3
GREEDY,2907,17,2,3,22
GREEDY,4457,17,2,3,22
GREEDY,5001,13,2,3,18
STINGY,1361,1,0,0,1
GREEDY,2186,16,2,3,21
GREEDY,1364,14,0,3,17
GREEDY,3695,16,2,3,21
STINGY,1412,1,0,1,2
STINGY,2136,5,1,1,7
GREEDY,4835,16,1,4,21
GREEDY,4930,16,1,3,20
GREEDY,1631,14,2,4,20
GREEDY,4461,17,1,3,21
GREEDY,1728,17,2,3,22
GREEDY,3056,13,1,4,18
STINGY,1763,1,0,1,2
GREEDY,3497,20,2,2,24
STINGY,960,1,0,1,2
STINGY,1662,1,0,1,2
GREEDY,5346,16,2,4,22
GREEDY,6542,16,1,3,20
GREEDY,566,16,1,4,21
GREEDY,8130,15,2,2,19
GREEDY,3765,15,1,3,19
STINGY,2012,2,0,1,3
GREEDY,2594,17,2,4,23
GREEDY,4903,16,2,3,21
STINGY,1349,1,0,1,2
GREEDY,2549,15,1,2,18
STINGY,1093,5,0,0,5
GREEDY,2136,19,1,4,24
STINGY,1007,7,1,1,9
GREEDY,3267,15,1,4,20
STINGY,1745,2,0,0,2
GREEDY,3866,16,1,2,19
GREEDY,6660,17,2,3,22
STINGY,1213,5,1,0,6
STINGY,1403,5,0,1,6
GREEDY,5051,14,2,2,18
STINGY,1422,5,0,1,6
GREEDY,47832,14,1,4,19
STINGY,1430,3,0,2,5
STINGY,658,4,0,0,4
STINGY,1439,2,0,3,5
GREEDY,3456,18,1,3,22
GREEDY,5915,14,1,3,18
STINGY,1448,1,1,0,2
GREEDY,2897,12,1,4,17
GREEDY,2382,19,0,4,23
GREEDY,11811,16,1,2,19
STINGY,1579,2,0,0,2
STINGY,1254,4,0,2,6
GREEDY,1312,18,0,4,22
STINGY,1914,2,0,0,2
GREEDY,5261,15,2,3,20
STINGY,1887,1,0,0,1
STINGY,1172,5,0,0,5
STINGY,1018,2,1,0,3
STINGY,1053,5,1,2,8
GREEDY,3645,13,1,4,18
GREEDY,3924,18,1,3,22
GREEDY,2305,17,2,3,22
STINGY,1530,1,0,0,1
STINGY,1427,4,0,1,5
STINGY,1109,4,0,1,5
STINGY,1702,0,1,0,1
GREEDY,5968,14,2,2,18
GREEDY,4455,18,2,2,22
STINGY,1518,8,1,2,11
STINGY,1032,4,0,0,4
GREEDY,6663,16,1,3,20
STINGY,1756,3,0,0,3
STINGY,1671,1,1,0,2
STINGY,1668,3,1,2,6
GREEDY,1246,15,2,4,21
STINGY,980,5,1,1,7
STINGY,1720,4,0,0,4
STINGY,2015,6,1,1,8
STINGY,1603,7,1,3,11
GREEDY,2075,14,2,3,19
GREEDY,4957,12,0,2,14
GREEDY,2508,12,1,3,16
GREEDY,4464,15,2,4,21
STINGY,652,4,1,2,7
GREEDY,2298,19,2,3,24
GREEDY,5413,19,2,3,24
GREEDY,2008,13,2,2,17
GREEDY,1847,14,2,4,20
GREEDY,3343,14,1,4,19
GREEDY,1763,11,2,3,16
GREEDY,4643,13,2,3,18
GREEDY,12106,14,1,3,18
STINGY,1544,1,0,0,1
GREEDY,6259,15,0,2,17
GREEDY,4116,17,1,4,22
GREEDY,2437,14,2,4,20
STINGY,940,4,1,1,6
GREEDY,1200,11,1,4,16
STINGY,1931,3,0,1,4
GREEDY,1666,14,1,4,19
STINGY,1822,1,0,0,1
GREEDY,2805,16,1,3,20
STINGY,1979,4,1,1,6
GREEDY,4135,16,2,4,22
GREEDY,7600,16,2,3,21
STINGY,1146,4,1,0,5
GREEDY,2248,14,2,4,20
STINGY,2140,2,0,0,2
GREEDY,1513,21,1,4,26
GREEDY,4355,16,2,2,20
GREEDY,4552,16,1,3,20
STINGY,2152,0,0,0,0
STINGY,864,8,0,1,9
STINGY,1154,2,0,0,2
GREEDY,3773,17,2,3,22
GREEDY,3394,17,1,4,22
GREEDY,3347,15,0,4,19
STINGY,914,3,0,0,3
GREEDY,1836,17,0,3,20
STINGY,1175,4,2,2,8
STINGY,1183,3,1,1,5
GREEDY,2323,16,2,4,22
GREEDY,5112,15,0,3,18
STINGY,1278,5,0,0,5
GREEDY,3227,19,2,4,25
STINGY,1639,5,0,0,5
STINGY,1315,3,0,0,3
STINGY,642,6,0,1,7
STINGY,410,6,0,1,7
GREEDY,932,16,1,2,19
STINGY,1333,3,0,1,4
STINGY,2220,2,1,0,3
STINGY,1567,1,0,0,1
GREEDY,3728,16,2,3,21
GREEDY,3730,17,2,2,21
STINGY,1284,5,0,0,5
GREEDY,2515,12,1,4,17
GREEDY,598,8,2,3,13
GREEDY,4724,15,1,2,18
STINGY,1821,2,0,1,3
GREEDY,2629,18,2,4,24
STINGY,38138,11,1,2,14
GREEDY,4122,18,1,3,22
GREEDY,7237,17,2,3,22
GREEDY,3581,16,1,2,19
GREEDY,3986,15,1,4,20
STINGY,1673,3,0,0,3
GREEDY,1552,12,2,2,16
GREEDY,2212,15,2,4,21
GREEDY,2797,16,2,4,22
STINGY,1973,4,0,1,5
STINGY,1772,1,0,1,2
GREEDY,1403,16,2,3,21
STINGY,1429,4,0,2,6
GREEDY,1914,16,2,4,22
STINGY,1067,5,0,2,7
STINGY,1584,3,0,0,3
GREEDY,11225,12,0,4,16
GREEDY,1764,17,2,2,21
STINGY,1244,3,0,0,3
GREEDY,5724,16,2,4,22
GREEDY,2930,14,2,3,19
STINGY,1602,3,0,1,4
STINGY,674,6,2,0,8
GREEDY,6748,17,2,1,20
STINGY,1494,5,0,0,5
GREEDY,4003,17,2,3,22
GREEDY,7659,13,2,4,19
STINGY,1150,2,0,0,2
STINGY,1087,3,1,0,4
GREEDY,3334,17,2,2,21
GREEDY,2292,14,1,3,18
GREEDY,3188,16,2,2,20
STINGY,1187,3,0,1,4
GREEDY,4389,16,1,3,20
GREEDY,6460,16,2,3,21
STINGY,1418,3,0,0,3
STINGY,1263,2,0,1,3
GREEDY,692,11,2,3,16
GREEDY,4258,15,1,3,19
GREEDY,7884,18,2,2,22
STINGY,1068,7,1,1,9
GREEDY,5975,14,2,4,20
STINGY,1165,2,0,1,3
GREEDY,1863,19,1,3,23
GREEDY,5418,19,1,3,23
GREEDY,2592,14,2,4,20
STINGY,558,6,0,0,6
STINGY,1068,2,0,1,3
STINGY,1268,3,0,0,3
GREEDY,6050,15,2,3,20
STINGY,1552,3,1,0,4
GREEDY,3349,16,1,4,21
GREEDY,2341,16,1,3,20
GREEDY,6617,16,2,1,19
GREEDY,3386,17,1,3,21
GREEDY,4113,14,1,3,18
GREEDY,3322,17,1,3,21
GREEDY,10213,16,1,3,20
STINGY,1355,2,0,0,2
GREEDY,955,16,2,4,22
STINGY,1667,2,0,1,3
STINGY,1367,2,0,2,4
STINGY,2182,2,1,0,3
STINGY,1412,5,0,0,5
STINGY,1036,3,1,0,4
STINGY,990,2,0,1,3
GREEDY,2337,15,2,4,21
STINGY,2498,0,0,0,0
GREEDY,133,7,1,2,10
GREEDY,1925,14,1,2,17
GREEDY,3968,15,2,4,21
STINGY,1598,3,0,0,3
STINGY,2152,3,2,1,6
STINGY,1124,2,0,0,2
GREEDY,2920,17,2,3,22
GREEDY,2544,11,1,4,16
GREEDY,2123,16,2,4,22
STINGY,2563,3,0,0,3
GREEDY,4444,18,2,2,22
GREEDY,5218,13,1,4,18
GREEDY,4142,14,2,3,19
GREEDY,6528,15,2,2,19
GREEDY,4263,14,0,3,17
STINGY,809,6,0,1,7
GREEDY,2560,18,2,3,23
STINGY,1059,6,0,2,8
GREEDY,5739,16,2,3,21
GREEDY,4944,17,1,3,21
STINGY,1835,3,0,1,4
STINGY,1511,4,0,0,4
GREEDY,4498,16,2,4,22
STINGY,1054,6,1,1,8
GREEDY,3055,16,2,3,21
GREEDY,3460,16,0,3,19
GREEDY,3856,15,2,4,21
STINGY,1652,1,0,0,1
STINGY,1277,5,1,0,6
GREEDY,353,11,2,4,17
GREEDY,1728,16,1,4,21
GREEDY,1541,20,1,3,24
GREEDY,10622,15,2,3,20
STINGY,1594,2,0,2,4
GREEDY,1972,14,1,4,19
STINGY,1356,3,0,0,3
GREEDY,2764,21,1,1,23
GREEDY,2592,15,2,4,21
GREEDY,4156,17,1,3,21
GREEDY,2363,20,2,4,26
STINGY,1022,2,1,1,4
STINGY,1359,4,1,1,6
GREEDY,224,14,0,3,17
GREEDY,3897,17,2,4,23
GREEDY,2252,18,1,3,22
GREEDY,3171,18,1,4,23
GREEDY,2367,16,1,3,20
STINGY,1191,4,0,1,5
GREEDY,3372,14,2,3,19
GREEDY,2855,17,0,3,20
STINGY,1513,3,0,1,4
STINGY,1774,2,1,0,3
GREEDY,4362,13,2,4,19
GREEDY,2273,14,0,3,17
STINGY,866,3,0,2,5
GREEDY,899,10,0,4,14
GREEDY,7681,13,1,4,18
GREEDY,3125,16,1,4,21
GREEDY,2943,16,2,3,21
GREEDY,1573,17,2,3,22
STINGY,2243,0,0,0,0
STINGY,1221,5,0,1,6
STINGY,1700,0,0,0,0
STINGY,1376,4,0,1,5
GREEDY,1973,14,2,2,18
GREEDY,2096,15,2,4,21
GREEDY,4105,13,1,3,17
GREEDY,3074,17,2,2,21
STINGY,1222,5,0,1,6
STINGY,1734,1,0,0,1
STINGY,942,6,1,2,9
STINGY,948,1,0,0,1
GREEDY,9642,15,1,2,18
GREEDY,3299,16,2,2,20
STINGY,1565,4,1,2,7
STINGY,1272,3,0,1,4
STINGY,1358,1,1,0,2
STINGY,1753,1,0,1,2
GREEDY,3147,16,2,4,22
GREEDY,3244,15,2,4,21
GREEDY,4836,16,1,2,19
STINGY,1130,5,0,0,5
STINGY,1755,0,0,1,1
STINGY,1601,6,0,0,6
STINGY,1868,3,0,1,4
GREEDY,3562,16,1,3,20
GREEDY,6011,14,2,3,19
STINGY,1233,3,0,0,3
GREEDY,6112,14,1,4,19
GREEDY,2644,14,2,4,20
GREEDY,2242,11,2,4,17
STINGY,1454,3,0,0,3
STINGY,1261,3,0,0,3
GREEDY,3758,14,2,1,17
GREEDY,6428,16,1,4,21
GREEDY,3916,15,0,4,19
GREEDY,12491,13,1,1,15
GREEDY,3432,19,1,4,24
GREEDY,6843,18,1,4,23
STINGY,1403,0,0,1,1
GREEDY,3140,14,2,3,19
GREEDY,3498,16,1,4,21
STINGY,1588,3,0,1,4
GREEDY,4708,15,1,4,20
STINGY,1731,6,2,1,9
STINGY,1146,3,0,0,3
GREEDY,3153,17,2,2,21
STINGY,1051,6,0,0,6
STINGY,600,5,0,0,5
GREEDY,2607,17,0,4,21
STINGY,2107,5,0,1,6
STINGY,1660,0,0,0,0
STINGY,1312,2,0,1,3
GREEDY,3943,15,1,4,20
GREEDY,3110,16,0,4,20
GREEDY,10641,16,2,2,20
STINGY,1802,4,0,0,4
STINGY,1499,4,0,2,6
GREEDY,4494,17,2,3,22
GREEDY,2690,18,2,4,24
STINGY,2099,3,0,0,3
GREEDY,1811,15,1,4,20
GREEDY,3045,13,1,4,18
STINGY,2195,4,2,0,6
STINGY,1431,5,0,0,5
GREEDY,1823,16,1,3,20
GREEDY,4753,14,1,3,18
STINGY,2696,1,1,2,4
GREEDY,3331,15,2,2,19
STINGY,891,5,0,1,6
GREEDY,3583,20,2,4,26
GREEDY,1928,20,2,2,24
GREEDY,6070,17,1,3,21
GREEDY,2446,18,2,3,23
GREEDY,878,13,1,2,16
GREEDY,1884,14,0,4,18
STINGY,1477,1,2,0,3
STINGY,2606,3,0,0,3
GREEDY,12032,14,2,3,19
GREEDY,3765,19,1,3,23
STINGY,2006,3,0,0,3
STINGY,1900,1,0,0,1
STINGY,775,3,0,2,5
STINGY,1534,2,0,0,2
GREEDY,4652,16,2,3,21
GREEDY,4775,16,2,4,22
STINGY,1549,5,0,2,7
GREEDY,2899,19,2,3,24
STINGY,1359,3,1,1,5
GREEDY,2782,16,1,3,20
STINGY,2306,4,0,1,5
GREEDY,4935,15,2,4,21
STINGY,2274,2,1,0,3
STINGY,2295,2,0,1,3
STINGY,1274,3,0,0,3
GREEDY,6861,14,1,4,19
STINGY,964,5,0,1,6
STINGY,1260,2,0,1,3
GREEDY,567,21,2,4,27
STINGY,1284,2,0,1,3
GREEDY,1876,19,1,4,24
STINGY,1492,2,0,0,2
GREEDY,8583,17,2,2,21
GREEDY,5037,16,1,2,19
GREEDY,5523,16,2,3,21
STINGY,1334,4,1,0,5
STINGY,1949,4,0,1,5
GREEDY,1596,17,1,3,21
GREEDY,4182,15,2,3,20
GREEDY,17242,16,2,2,20
STINGY,1456,4,0,0,4
GREEDY,4659,17,1,1,19
STINGY,705,5,0,1,6
GREEDY,4491,14,1,4,19
GREEDY,6022,16,0,3,19
GREEDY,2574,19,2,4,25
GREEDY,3514,15,2,4,21
GREEDY,3426,15,2,3,20
GREEDY,4358,14,2,2,18
GREEDY,3532,15,2,4,21
GREEDY,2750,17,2,4,23
GREEDY,3112,16,1,4,21
GREEDY,2533,16,0,4,20
GREEDY,1991,13,2,2,17
STINGY,1283,2,0,1,3
STINGY,1517,1,1,0,2
GREEDY,3734,17,2,3,22
GREEDY,2532,19,0,2,21
STINGY,1914,1,0,0,1
GREEDY,6800,17,1,3,21
GREEDY,977,16,2,3,21
STINGY,1126,2,0,0,2
GREEDY,4923,18,1,4,23
STINGY,2089,3,0,1,4
GREEDY,4987,13,1,4,18
GREEDY,3284,15,2,3,20
GREEDY,3977,19,2,3,24
STINGY,2399,1,0,1,2
GREEDY,1132,13,2,4,19
GREEDY,4527,15,2,4,21
GREEDY,3183,16,1,4,21
GREEDY,2719,15,2,4,21
GREEDY,3884,16,2,4,22
GREEDY,7233,16,2,4,22
STINGY,1502,2,0,0,2
STINGY,871,5,0,1,6
STINGY,1432,1,0,0,1
GREEDY,691,10,2,3,15
GREEDY,7796,16,2,4,22
GREEDY,2656,15,2,2,19
STINGY,426,6,0,2,8
STINGY,2715,1,1,0,2
GREEDY,2974,18,2,3,23
GREEDY,2589,13,2,4,19
STINGY,881,6,0,0,6
GREEDY,4750,16,2,2,20
STINGY,1778,2,0,3,5
STINGY,2008,5,0,0,5
STINGY,2245,2,1,0,3
STINGY,1452,5,0,0,5
STINGY,1909,2,0,0,2
GREEDY,4574,16,2,2,20
GREEDY,2346,18,2,3,23
GREEDY,4953,12,1,3,16
GREEDY,12273,16,2,3,21
GREEDY,9029,16,1,3,20
STINGY,2588,7,0,0,7
STINGY,1790,2,0,0,2
GREEDY,42068,15,0,2,17
STINGY,1706,3,0,0,3
STINGY,1601,1,0,1,2
GREEDY,2936,17,1,4,22
GREEDY,6619,17,1,3,21
GREEDY,2129,15,2,4,21
STINGY,1782,1,1,1,3
GREEDY,2748,16,1,3,20
GREEDY,2540,14,0,4,18
STINGY,1168,3,0,1,4
STINGY,2266,3,0,1,4
GREEDY,2973,16,1,2,19
GREEDY,3848,16,2,3,21
STINGY,881,5,1,1,7
STINGY,858,4,0,0,4
STINGY,1773,0,0,0,0
STINGY,2686,1,1,0,2
GREEDY,15546,16,2,3,21
GREEDY,3040,14,0,4,18
GREEDY,1279,17,0,1,18
GREEDY,4899,17,2,3,22
GREEDY,4989,17,2,2,21
STINGY,2047,1,1,0,2
STINGY,1650,3,0,0,3
STINGY,1973,2,0,0,2
GREEDY,4378,14,1,1,16
STINGY,782,7,0,0,7
STINGY,2225,0,0,0,0
STINGY,1520,7,1,0,8
GREEDY,2309,18,1,3,22
GREEDY,1839,18,0,2,20
GREEDY,3598,16,1,3,20
STINGY,1780,0,1,1,2
STINGY,1495,7,1,1,9
STINGY,1227,4,0,0,4
GREEDY,8593,14,1,3,18
GREEDY,2829,17,1,4,22
GREEDY,3030,13,1,4,18
GREEDY,4563,18,2,3,23
STINGY,1674,4,0,2,6
GREEDY,4226,15,2,4,21
GREEDY,4376,15,2,2,19
GREEDY,3064,15,1,3,19
GREEDY,5801,16,2,3,21
GREEDY,2619,17,2,3,22
GREEDY,5851,14,1,4,19
STINGY,980,3,0,1,4
STINGY,1597,4,0,1,5
STINGY,698,4,0,2,6
GREEDY,24376,15,1,2,18
STINGY,1825,1,0,1,2
STINGY,727,4,1,1,6
GREEDY,1422,13,1,4,18
STINGY,1403,1,0,1,2
GREEDY,1176,14,1,2,17
GREEDY,5720,17,1,2,20
GREEDY,3761,18,2,1,21
GREEDY,3187,11,2,4,17
STINGY,1770,1,1,1,3
GREEDY,5975,18,1,4,23
GREEDY,5480,16,1,2,19
GREEDY,3133,18,2,2,22
GREEDY,1226,13,1,4,18
STINGY,1299,2,1,1,4
STINGY,1299,2,0,1,3
STINGY,864,3,0,0,3
STINGY,1294,4,0,0,4
GREEDY,8084,15,0,3,18
GREEDY,4143,14,1,2,17
STINGY,400,4,0,0,4
STINGY,1098,2,1,0,3
GREEDY,4649,15,2,2,19
GREEDY,5369,15,2,2,19
GREEDY,5117,15,2,3,20
GREEDY,4441,15,2,3,20
GREEDY,4204,15,2,4,21
STINGY,2201,2,0,0,2
GREEDY,3341,17,2,2,21
GREEDY,2407,17,1,3,21
STINGY,993,2,0,2,4
GREEDY,2152,14,2,3,19
GREEDY,3638,15,1,3,19
STINGY,970,2,0,1,3
STINGY,1699,2,0,3,5
GREEDY,4321,17,2,4,23
STINGY,1260,1,1,0,2
GREEDY,4857,16,2,2,20
GREEDY,2865,12,1,4,17
STINGY,1108,6,0,1,7
GREEDY,3624,13,2,3,18
GREEDY,4495,16,2,4,22
GREEDY,915,12,1,3,16
GREEDY,3336,21,1,4,26
STINGY,1702,2,0,0,2
STINGY,2007,4,1,1,6
STINGY,933,2,0,2,4
GREEDY,3975,18,2,3,23
GREEDY,636,15,1,4,20
STINGY,1367,1,1,0,2
GREEDY,6866,14,1,3,18
GREEDY,5087,15,2,3,20
STINGY,1430,2,1,0,3
STINGY,1024,1,1,0,2
STINGY,1184,3,0,2,5
STINGY,1558,6,0,0,6
STINGY,2234,1,0,1,2
GREEDY,1068,12,1,4,17
STINGY,1953,5,1,2,8
STINGY,1345,1,1,0,2
STINGY,1593,1,0,0,1
STINGY,1088,2,0,2,4
STINGY,746,4,1,1,6
GREEDY,3026,18,1,4,23
GREEDY,3129,14,1,3,18
GREEDY,5701,15,1,3,19
GREEDY,3152,16,2,3,21
STINGY,1923,1,0,0,1
GREEDY,3363,15,1,4,20
GREEDY,2084,16,1,4,21
STINGY,1663,2,0,1,3
GREEDY,2179,18,2,3,23
STINGY,1862,3,0,0,3
STINGY,829,3,1,1,5
STINGY,540,5,0,3,8
GREEDY,3867,17,2,1,20
STINGY,1554,3,0,0,3
STINGY,1244,2,1,1,4
STINGY,1530,2,0,1,3
GREEDY,5371,16,2,3,21
GREEDY,3194,16,1,4,21
GREEDY,4486,16,2,4,22
STINGY,1568,3,0,1,4
GREEDY,2481,15,1,3,19
GREEDY,4141,17,0,3,20
GREEDY,2653,17,2,3,22
GREEDY,4732,14,1,2,17
GREEDY,13952,14,1,3,18
GREEDY,3206,15,1,4,20
GREEDY,3815,16,1,3,20
STINGY,2107,1,0,0,1
GREEDY,2714,17,2,3,22
STINGY,1079,3,0,1,4
STINGY,433,3,1,0,4
STINGY,1058,1,1,0,2
GREEDY,2503,17,1,3,21
STINGY,1246,4,1,2,7
GREEDY,2832,18,1,4,23
STINGY,858,5,0,2,7
GREEDY,3274,13,2,4,19
STINGY,1633,1,1,2,4
GREEDY,3497,14,1,2,17
GREEDY,2552,15,2,3,20
GREEDY,3431,16,2,3,21
GREEDY,4135,15,2,3,20
STINGY,1482,3,1,0,4
GREEDY,3641,19,2,4,25
GREEDY,990,13,2,4,19
GREEDY,4978,17,2,2,21
GREEDY,1951,14,1,2,17
STINGY,2015,1,0,1,2
GREEDY,14119,14,2,3,19
GREEDY,6439,15,1,4,20
GREEDY,3117,16,2,2,20
STINGY,1744,5,0,0,5
GREEDY,9076,15,1,3,19
STINGY,1564,1,1,1,3
STINGY,1297,4,2,0,6
STINGY,1635,3,0,1,4
GREEDY,2491,18,1,2,21
GREEDY,21619,16,1,3,20
GREEDY,21041,15,1,3,19
STINGY,1222,2,0,1,3
GREEDY,894,13,2,4,19
STINGY,1557,3,0,1,4
GREEDY,2655,15,1,2,18
GREEDY,3085,16,2,3,21
GREEDY,1239,16,2,3,21
STINGY,1750,4,0,0,4
STINGY,1451,4,0,1,5
STINGY,1078,3,2,0,5
STINGY,990,1,1,2,4
GREEDY,6800,15,2,2,19
GREEDY,5204,13,1,2,16
GREEDY,2325,17,2,4,23
GREEDY,5012,16,2,4,22
GREEDY,4635,18,1,4,23
GREEDY,5467,15,2,3,20
GREEDY,3283,16,0,4,20
GREEDY,1312,12,2,4,18
STINGY,1378,4,1,1,6
STINGY,2084,4,1,1,6
GREEDY,7285,17,2,4,23
STINGY,1375,3,0,1,4
STINGY,1654,1,0,0,1
GREEDY,3764,17,2,4,23
STINGY,1276,4,0,1,5
GREEDY,3624,16,2,3,21
GREEDY,3720,16,2,3,21
GREEDY,2112,14,1,4,19
STINGY,612,2,0,1,3
GREEDY,5009,14,1,3,18
STINGY,1684,4,0,0,4
STINGY,2205,1,0,1,2
STINGY,1583,0,1,1,2
STINGY,1149,8,0,1,9
STINGY,994,5,1,1,7
STINGY,1252,3,1,0,4
GREEDY,2414,13,2,2,17
GREEDY,3018,18,1,2,21
GREEDY,3382,17,2,3,22
GREEDY,5188,15,2,4,21
GREEDY,1573,19,2,4,25
STINGY,1520,3,0,1,4
STINGY,1554,2,0,0,2
STINGY,524,5,1,3,9
STINGY,1620,2,0,0,2
STINGY,1204,5,1,1,7
STINGY,1893,3,0,0,3
STINGY,1882,3,0,1,4
STINGY,1706,0,0,1,1
STINGY,1896,2,0,1,3
GREEDY,5492,14,2,2,18
GREEDY,7993,15,1,1,17
GREEDY,7128,16,1,3,20
GREEDY,2695,16,1,3,20
STINGY,1942,0,0,0,0
GREEDY,581,10,2,3,15
GREEDY,2245,18,2,3,23
STINGY,1644,3,2,2,7
STINGY,1951,2,0,0,2
STINGY,1613,3,0,0,3
GREEDY,6883,11,2,3,16
STINGY,2030,1,0,0,1
GREEDY,1535,18,0,3,21
STINGY,1869,4,0,0,4
GREEDY,1386,17,2,3,22
STINGY,1882,5,0,1,6
GREEDY,2540,14,1,3,18
GREEDY,5803,18,2,2,22
STINGY,2026,1,0,0,1
GREEDY,6233,15,2,2,19
STINGY,2112,3,0,0,3
GREEDY,5363,15,2,1,18
GREEDY,3440,16,0,2,18
STINGY,2133,3,0,0,3
GREEDY,4422,16,2,4,22
GREEDY,2680,17,2,4,23
GREEDY,4697,16,2,4,22
STINGY,1314,2,0,0,2
GREEDY,4681,17,0,4,21
GREEDY,2889,13,2,4,19
STINGY,1456,3,0,1,4
STINGY,1749,1,0,2,3
GREEDY,7083,15,2,2,19
GREEDY,10160,15,1,3,19
GREEDY,6445,16,1,3,20
GREEDY,2458,19,2,2,23
STINGY,1666,2,0,1,3
GREEDY,5338,15,2,1,18
STINGY,1414,5,0,1,6
STINGY,1912,0,0,0,0
GREEDY,4094,17,0,3,20
STINGY,1042,3,0,0,3
STINGY,1666,4,0,2,6
STINGY,1346,4,0,0,4
GREEDY,6917,14,1,3,18
GREEDY,2163,13,2,4,19
GREEDY,4365,16,0,3,19
STINGY,1172,1,2,1,4
GREEDY,11094,15,1,3,19
STINGY,1198,5,0,1,6
GREEDY,3083,18,0,3,21
STINGY,1815,3,1,0,4
GREEDY,4145,15,1,2,18
STINGY,1710,1,0,0,1
STINGY,956,2,0,1,3
GREEDY,3162,19,2,2,23
STINGY,1324,3,0,1,4
GREEDY,1574,17,1,3,21
STINGY,1153,2,1,0,3
STINGY,1442,2,0,1,3
GREEDY,2424,13,2,3,18
GREEDY,676,18,2,4,24
GREEDY,6147,14,1,3,18
STINGY,1512,3,2,0,5
GREEDY,3091,16,1,1,18
GREEDY,5730,13,1,3,17
GREEDY,4596,18,2,2,22
GREEDY,6383,16,2,2,20
GREEDY,4784,18,2,2,22
GREEDY,5858,18,1,3,22
STINGY,1893,4,0,0,4
GREEDY,10603,18,1,3,22
STINGY,1318,4,0,0,4
GREEDY,4340,18,2,3,23
GREEDY,5429,19,2,3,24
GREEDY,1292,13,1,3,17
STINGY,1244,7,1,1,9
GREEDY,2601,16,1,4,21
GREEDY,4312,17,1,1,19
STINGY,2124,2,0,2,4
GREEDY,1276,13,0,3,16
GREEDY,4358,17,2,2,21
GREEDY,4607,13,2,4,19
GREEDY,5635,17,2,2,21
GREEDY,61141,12,1,4,17
STINGY,1919,2,0,1,3
GREEDY,9164,17,2,3,22
GREEDY,2831,15,2,4,21
GREEDY,3845,14,2,4,20
STINGY,1479,4,0,0,4
STINGY,1163,3,1,2,6
STINGY,1565,6,1,0,7
STINGY,1355,1,0,1,2
GREEDY,4219,15,2,4,21
GREEDY,2847,13,2,4,19
GREEDY,1113,14,1,4,19
STINGY,1821,4,0,0,4
GREEDY,1123,11,2,0,13
STINGY,1958,0,0,0,0
STINGY,1763,1,0,0,1
GREEDY,8365,15,2,4,21
STINGY,1060,3,1,2,6
GREEDY,2981,18,1,3,22
STINGY,1966,2,0,0,2
STINGY,1399,3,1,1,5
STINGY,1073,3,0,0,3
GREEDY,3559,16,2,3,21
STINGY,1332,2,1,1,4
STINGY,1522,3,0,1,4
STINGY,1193,1,1,2,4
GREEDY,2387,17,1,4,22
STINGY,1687,3,0,0,3
STINGY,807,5,0,1,6
STINGY,1646,4,0,2,6
GREEDY,5706,15,2,3,20
STINGY,1290,5,0,0,5
STINGY,798,4,0,1,5
GREEDY,2484,15,2,3,20
STINGY,1297,6,1,3,10
GREEDY,4546,18,0,3,21
GREEDY,3547,18,2,3,23
GREEDY,2065,17,1,4,22
STINGY,1186,3,1,0,4
STINGY,1716,3,0,1,4
GREEDY,2021,12,0,3,15
GREEDY,1917,16,2,3,21
STINGY,1842,1,0,0,1
GREEDY,3376,17,2,2,21
GREEDY,3543,17,2,3,22
GREEDY,3848,16,2,3,21
STINGY,1107,2,0,1,3
GREEDY,3216,17,2,3,22
GREEDY,1865,19,1,2,22
STINGY,1809,0,0,1,1
GREEDY,1209,17,2,4,23
GREEDY,2472,16,1,2,19
STINGY,985,4,0,1,5
GREEDY,4881,16,2,4,22
GREEDY,1195,15,2,4,21
GREEDY,3948,15,2,3,20
STINGY,760,3,0,2,5
GREEDY,3047,17,2,2,21
STINGY,1042,4,0,0,4
STINGY,1667,2,0,0,2
STINGY,1324,3,0,0,3
STINGY,1137,4,1,0,5
STINGY,1718,2,0,0,2
STINGY,910,3,1,0,4
GREEDY,3320,17,1,4,22
GREEDY,3056,19,2,2,23
STINGY,1499,5,1,1,7
GREEDY,6685,16,2,3,21
GREEDY,6629,16,2,2,20
GREEDY,4487,18,1,2,21
GREEDY,3014,16,2,4,22
GREEDY,6671,18,2,3,23
GREEDY,5317,17,1,3,21
GREEDY,1960,15,2,3,20
STINGY,766,7,1,1,9
GREEDY,2977,15,2,4,21
STINGY,945,5,0,1,6
GREEDY,10106,17,2,3,22
STINGY,651,4,0,1,5
STINGY,1156,3,0,1,4
GREEDY,2985,16,2,2,20
GREEDY,2207,19,0,3,22
GREEDY,398,16,2,3,21
STINGY,2012,1,0,0,1
GREEDY,3824,14,2,4,20
GREEDY,1648,15,2,4,21
GREEDY,3819,13,1,4,18
STINGY,1740,2,0,0,2
GREEDY,5143,18,1,3,22
GREEDY,4446,17,2,3,22
GREEDY,3434,15,1,4,20
STINGY,1737,1,0,2,3
STINGY,1700,0,0,0,0
GREEDY,3499,17,1,2,20
STINGY,2450,1,1,0,2
STINGY,1876,1,0,0,1
STINGY,1388,5,1,1,7
GREEDY,3760,15,2,2,19
GREEDY,7122,13,2,4,19
STINGY,2273,3,0,1,4
GREEDY,3645,17,1,3,21
STINGY,1718,5,0,0,5
STINGY,1744,2,0,1,3
GREEDY,3097,17,2,3,22
GREEDY,2501,14,2,4,20
STINGY,1029,4,0,3,7
STINGY,2643,2,0,0,2
STINGY,1252,3,0,0,3
STINGY,1274,2,0,0,2
GREEDY,3935,16,1,3,20
STINGY,1305,2,0,1,3
STINGY,1429,3,0,2,5
STINGY,1037,1,1,1,3
STINGY,1188,5,0,1,6
STINGY,334,6,0,3,9
GREEDY,2424,19,1,2,22
GREEDY,2537,11,2,4,17
STINGY,1196,3,1,1,5
GREEDY,2995,17,1,3,21
STINGY,410,4,0,2,6
GREEDY,1275,18,1,2,21
GREEDY,8728,14,1,4,19
STINGY,1402,2,1,2,5
GREEDY,3281,16,2,3,21
STINGY,1574,2,0,0,2
STINGY,744,6,1,0,7
STINGY,1065,5,0,0,5
GREEDY,4723,17,2,3,22
STINGY,2054,1,0,1,2
GREEDY,5484,14,1,4,19
STINGY,1570,2,0,0,2
GREEDY,1846,16,1,4,21
GREEDY,4522,19,2,2,23
STINGY,1814,0,1,1,2
GREEDY,1556,13,2,1,16
STINGY,1754,5,0,1,6
GREEDY,3579,14,1,4,19
GREEDY,3294,12,2,4,18
STINGY,904,7,0,0,7
STINGY,2363,0,0,0,0
GREEDY,4003,17,2,4,23
GREEDY,3088,18,1,4,23
GREEDY,2427,17,1,3,21
STINGY,1524,1,0,0,1
GREEDY,4753,17,1,2,20
STINGY,1108,4,2,1,7
GREEDY,4961,12,2,3,17
STINGY,1075,3,0,0,3
STINGY,2142,4,0,0,4
GREEDY,5173,14,2,3,19
GREEDY,4054,13,2,2,17
STINGY,1512,3,0,1,4
STINGY,1544,1,0,1,2
GREEDY,3627,17,1,3,21
STINGY,1278,3,0,0,3
GREEDY,5247,14,2,2,18
STINGY,295,3,1,1,5
GREEDY,5491,18,1,2,21
GREEDY,10884,14,1,3,18
STINGY,726,4,0,2,6
STINGY,838,1,1,0,2
GREEDY,4251,18,2,4,24
STINGY,1668,4,1,1,6
STINGY,1534,4,0,0,4
GREEDY,4785,18,1,2,21
GREEDY,1458,17,2,4,23
STINGY,1730,2,0,0,2
GREEDY,6217,17,2,3,22
GREEDY,1998,17,2,3,22
GREEDY,1986,14,2,4,20
GREEDY,3254,16,1,2,19
GREEDY,3851,18,1,4,23
GREEDY,2164,14,2,2,18
STINGY,1854,0,1,0,1
STINGY,2432,1,1,0,2
GREEDY,2813,15,2,3,20
GREEDY,2337,15,2,2,19
GREEDY,4047,18,2,4,24
GREEDY,5803,15,1,3,19
GREEDY,895,19,1,4,24
STINGY,1787,1,0,0,1
GREEDY,2317,12,0,4,16
GREEDY,645,10,1,3,14
GREEDY,4637,16,2,3,21
STINGY,1678,5,1,1,7
STINGY,1990,1,1,0,2
GREEDY,2821,16,2,4,22
GREEDY,5052,16,1,4,21
GREEDY,3950,15,1,3,19
STINGY,1429,0,0,0,0
GREEDY,10968,14,1,3,18
STINGY,1891,1,0,0,1
STINGY,1819,4,0,0,4
STINGY,2800,5,2,1,8
STINGY,1884,2,1,1,4
STINGY,652,3,1,1,5
GREEDY,2339,12,2,4,18
STINGY,1921,6,0,2,8
GREEDY,2189,16,2,3,21
GREEDY,4658,16,2,3,21
STINGY,2289,3,1,3,7
STINGY,797,2,0,1,3
GREEDY,2793,12,0,2,14
GREEDY,6566,17,2,4,23
STINGY,2046,0,1,0,1
STINGY,913,2,1,1,4
GREEDY,11990,14,1,1,16
GREEDY,1414,12,2,1,15
GREEDY,2965,16,2,3,21
GREEDY,2163,17,1,3,21
GREEDY,3361,16,2,1,19
GREEDY,4589,14,2,2,18
GREEDY,2068,18,1,4,23
GREEDY,2592,19,2,4,25
GREEDY,3808,12,1,3,16
STINGY,2055,4,1,0,5
STINGY,1802,0,1,0,1
GREEDY,4469,17,2,1,20
GREEDY,5561,15,2,3,20
GREEDY,6418,17,2,4,23
GREEDY,2620,15,0,3,18
GREEDY,1524,17,2,4,23
GREEDY,3338,17,2,3,22
GREEDY,4676,17,2,4,23
GREEDY,3213,14,1,3,18
GREEDY,443,13,1,3,17
STINGY,1373,5,1,0,6
STINGY,1136,5,1,0,6
GREEDY,3256,17,1,3,21
GREEDY,2232,13,2,2,17
GREEDY,9084,14,1,3,18
STINGY,1216,3,0,0,3
STINGY,3186,4,0,3,7
GREEDY,1347,8,2,4,14
STINGY,1230,3,0,2,5
GREEDY,6110,16,0,3,19
GREEDY,5485,15,1,2,18
STINGY,1937,1,1,1,3
GREEDY,9146,14,2,3,19
STINGY,920,5,0,0,5
GREEDY,4667,17,1,3,21
STINGY,1316,3,1,0,4
GREEDY,2185,15,1,2,18
GREEDY,1191,17,2,3,22
GREEDY,2194,17,1,2,20
GREEDY,2549,16,2,2,20
STINGY,1629,0,0,1,1
STINGY,1644,2,0,1,3
GREEDY,4254,15,0,4,19
GREEDY,2336,18,2,2,22
GREEDY,3817,15,2,2,19
GREEDY,6474,17,2,3,22
GREEDY,4959,15,1,4,20
GREEDY,1195,18,1,4,23
GREEDY,3969,17,2,3,22
GREEDY,1261,13,1,4,18
GREEDY,2786,17,1,3,21
GREEDY,3666,16,1,2,19
GREEDY,4755,19,2,3,24
STINGY,2061,1,0,0,1
GREEDY,2123,15,1,4,20
STINGY,1873,3,0,0,3
GREEDY,2621,16,1,1,18
STINGY,1738,4,0,0,4
GREEDY,3502,15,1,3,19
GREEDY,5386,14,2,3,19
GREEDY,1565,15,1,4,20
GREEDY,5976,17,2,3,22
GREEDY,3650,17,2,4,23
STINGY,1730,0,0,0,0
GREEDY,1108,15,1,4,20
GREEDY,3585,16,2,3,21
STINGY,1649,4,0,1,5
STINGY,2449,1,0,0,1
STINGY,1727,7,0,1,8
GREEDY,3693,14,2,4,20
GREEDY,4393,19,2,2,23
STINGY,1281,2,0,0,2
GREEDY,3440,17,1,2,20
GREEDY,3722,17,2,3,22
GREEDY,4751,18,2,3,23
GREEDY,2970,18,2,2,22
STINGY,1311,5,0,1,6
GREEDY,16047,13,2,1,16
STINGY,1492,3,0,0,3
GREEDY,24177,14,2,3,19
GREEDY,7747,17,1,3,21
GREEDY,3216,17,2,2,21
STINGY,1642,5,0,1,6
STINGY,2296,3,1,1,5
GREEDY,2720,16,0,3,19
GREEDY,4467,17,1,3,21
STINGY,1025,3,1,1,5
GREEDY,2443,14,1,2,17
GREEDY,14905,15,1,3,19
GREEDY,5952,17,2,3,22
STINGY,1781,1,0,0,1
GREEDY,840,14,0,3,17
GREEDY,5142,15,2,3,20
GREEDY,3541,15,2,3,20
STINGY,1659,0,0,0,0
GREEDY,2609,16,2,3,21
GREEDY,4493,17,2,4,23
GREEDY,6395,15,2,4,21
STINGY,639,7,1,3,11
GREEDY,10244,14,2,3,19
GREEDY,4567,16,1,3,20
STINGY,1519,2,1,0,3
GREEDY,5919,18,1,4,23
GREEDY,3695,17,2,4,23
STINGY,1858,5,1,0,6
GREEDY,6065,17,2,3,22
STINGY,2172,2,0,0,2
STINGY,1624,1,0,2,3
GREEDY,2979,12,2,4,18
STINGY,1733,4,0,1,5
GREEDY,5848,16,1,3,20
GREEDY,2323,16,2,2,20
GREEDY,4634,17,2,4,23
STINGY,1267,3,1,0,4
GREEDY,3322,16,0,3,19
STINGY,1151,4,0,0,4
GREEDY,3608,14,2,3,19
GREEDY,927,16,1,4,21
GREEDY,1044,16,0,3,19
GREEDY,4436,14,1,4,19
STINGY,1808,2,0,1,3
STINGY,1606,2,0,0,2
GREEDY,3586,13,1,4,18
GREEDY,6759,15,2,2,19
STINGY,1379,4,0,0,4
GREEDY,8317,15,2,2,19
GREEDY,2346,17,1,3,21
STINGY,793,2,1,0,3
GREEDY,2790,20,1,2,23
GREEDY,4760,17,1,3,21
GREEDY,8741,16,0,2,18
GREEDY,4998,14,2,3,19
GREEDY,5611,16,2,3,21
GREEDY,3549,18,2,3,23
GREEDY,4569,14,1,3,18
GREEDY,2316,16,1,0,17
STINGY,1170,3,0,0,3
GREEDY,3552,15,2,4,21
GREEDY,2517,16,1,3,20
GREEDY,3355,14,2,2,18
GREEDY,1154,14,2,3,19
GREEDY,2058,13,2,4,19
GREEDY,1822,17,2,3,22
STINGY,1752,3,1,1,5
GREEDY,2246,14,2,2,18
GREEDY,5384,12,2,4,18
GREEDY,3682,16,1,2,19
STINGY,1341,3,0,0,3
GREEDY,3396,16,1,3,20
STINGY,1375,0,0,2,2
STINGY,1428,5,0,2,7
STINGY,1410,3,0,0,3
STINGY,1655,3,1,2,6
STINGY,342,7,0,0,7
GREEDY,6995,13,2,3,18
GREEDY,2644,15,1,3,19
STINGY,1374,3,1,0,4
STINGY,1390,4,1,1,6
GREEDY,2186,16,1,3,20
GREEDY,2766,18,2,4,24
GREEDY,2240,16,2,4,22
STINGY,1564,1,0,0,1
STINGY,2250,4,0,1,5
GREEDY,5300,17,1,4,22
GREEDY,6108,12,2,2,16
STINGY,1696,2,0,2,4
STINGY,1414,4,1,0,5
GREEDY,5267,15,1,4,20
GREEDY,1805,16,1,4,21
STINGY,1683,5,0,2,7
GREEDY,2984,13,2,2,17
GREEDY,3467,18,2,1,21
GREEDY,4614,15,2,2,19
GREEDY,4277,18,2,2,22
GREEDY,2171,17,1,3,21
STINGY,2113,5,1,0,6
STINGY,908,5,1,1,7
STINGY,1560,1,0,0,1
GREEDY,1572,16,2,3,21
STINGY,2028,1,1,0,2
STINGY,2153,7,1,0,8
GREEDY,5286,17,1,3,21
STINGY,1149,5,0,3,8
GREEDY,3222,15,2,4,21
GREEDY,3987,16,2,3,21
STINGY,1594,2,0,0,2
GREEDY,2174,15,1,4,20
GREEDY,3200,16,2,4,22
STINGY,1345,7,0,3,10
GREEDY,2130,16,1,4,21
GREEDY,3403,18,1,4,23
GREEDY,932,15,2,3,20
GREEDY,1801,16,2,2,20
STINGY,886,4,0,1,5
STINGY,972,3,0,1,4
GREEDY,1869,19,2,2,23
STINGY,1608,3,0,1,4
GREEDY,3523,16,1,3,20
GREEDY,4479,17,1,3,21
STINGY,1032,3,1,2,6
STINGY,843,5,1,0,6
GREEDY,8109,14,1,4,19
GREEDY,3331,17,2,3,22
GREEDY,2005,20,1,2,23
GREEDY,1902,16,2,4,22
STINGY,1238,4,0,0,4
STINGY,1496,2,0,0,2
GREEDY,3713,13,1,4,18
GREEDY,2436,17,1,4,22
STINGY,894,3,0,1,4
STINGY,1357,5,0,1,6
STINGY,1467,2,0,0,2
GREEDY,3938,13,2,3,18
STINGY,1871,1,0,0,1
GREEDY,4051,18,1,3,22
GREEDY,4579,16,2,3,21
STINGY,1632,1,0,0,1
GREEDY,3644,17,2,3,22
STINGY,1822,3,0,0,3
GREEDY,5370,17,1,3,21
STINGY,1716,4,0,0,4
STINGY,610,7,1,0,8
GREEDY,4062,16,1,3,20
GREEDY,5169,17,0,3,20
GREEDY,2706,14,2,3,19
GREEDY,3778,17,1,3,21
GREEDY,1281,13,2,3,18
STINGY,1937,1,0,0,1
STINGY,1916,9,1,2,12
STINGY,1251,1,0,1,2
GREEDY,10603,15,2,2,19
STINGY,1937,3,0,1,4
STINGY,2241,2,0,0,2
STINGY,1616,1,0,0,1
GREEDY,5713,15,2,3,20
STINGY,1878,0,0,1,1
GREEDY,4349,19,2,2,23
STINGY,1959,1,2,1,4
GREEDY,8400,15,2,3,20
STINGY,992,5,1,0,6
GREEDY,4125,18,1,3,22
GREEDY,6267,16,2,3,21
GREEDY,2207,13,2,2,17
GREEDY,8609,14,2,3,19
GREEDY,4469,16,2,3,21
GREEDY,3589,16,1,2,19
GREEDY,3060,19,1,3,23
STINGY,1333,3,0,0,3
STINGY,1008,6,0,3,9
STINGY,1254,2,0,0,2
GREEDY,10472,14,2,3,19
GREEDY,2521,17,1,2,20
STINGY,1120,6,1,1,8
STINGY,1762,3,0,0,3
STINGY,1337,4,1,2,7
STINGY,2208,3,0,1,4
STINGY,1734,1,0,0,1
GREEDY,7078,18,1,3,22
GREEDY,5093,17,0,2,19
STINGY,1554,2,0,0,2
GREEDY,5513,16,2,4,22
STINGY,1533,3,0,0,3
GREEDY,3148,16,2,1,19
STINGY,1078,3,1,0,4
GREEDY,5731,16,1,4,21
GREEDY,3467,18,1,3,22
GREEDY,3265,15,2,3,20
GREEDY,9080,16,1,3,20
STINGY,1625,0,0,1,1
GREEDY,2694,18,2,3,23
GREEDY,2898,19,2,3,24
GREEDY,8565,16,1,1,18
STINGY,2256,2,1,0,3
GREEDY,10057,14,0,3,17
STINGY,1894,6,0,2,8
GREEDY,7626,14,1,3,18
GREEDY,2550,16,0,2,18
GREEDY,3272,14,2,3,19
GREEDY,3238,16,2,3,21
STINGY,1121,3,1,0,4
STINGY,1661,3,1,1,5
GREEDY,1919,12,2,4,18
GREEDY,4739,16,1,2,19
STINGY,1658,4,0,0,4
STINGY,1247,3,0,1,4
GREEDY,2473,15,2,2,19
GREEDY,2967,16,1,4,21
GREEDY,1233,14,2,4,20
GREEDY,2823,17,1,3,21
STINGY,1311,6,0,2,8
GREEDY,1530,10,1,4,15
GREEDY,5929,14,1,4,19
GREEDY,3969,15,2,2,19
STINGY,2025,1,0,0,1
GREEDY,2264,19,2,2,23
GREEDY,2860,16,2,3,21
GREEDY,3180,16,2,3,21
GREEDY,3456,14,2,2,18
STINGY,2418,5,0,2,7
GREEDY,1601,14,1,3,18
GREEDY,7835,17,2,4,23
GREEDY,3377,18,2,3,23
STINGY,1712,3,0,1,4
GREEDY,3007,12,2,3,17
STINGY,1768,1,0,1,2
GREEDY,3656,17,1,3,21
GREEDY,3463,17,2,3,22
STINGY,495,7,0,1,8
GREEDY,3457,16,2,3,21
GREEDY,6904,17,1,2,20
STINGY,1624,5,0,1,6
STINGY,1093,6,1,1,8
GREEDY,4889,16,1,3,20
GREEDY,1785,14,2,4,20
STINGY,1564,1,0,0,1
GREEDY,12666,12,2,2,16
GREEDY,2822,17,2,4,23
GREEDY,4478,18,1,3,22
STINGY,1433,3,0,2,5
GREEDY,1878,17,1,3,21
STINGY,1750,0,0,0,0
STINGY,1941,6,2,3,11
STINGY,1677,1,0,0,1
STINGY,1180,3,0,1,4
GREEDY,3007,19,1,2,22
STINGY,1939,1,0,0,1
STINGY,1849,0,0,0,0
STINGY,1413,4,0,0,4
STINGY,1235,3,1,0,4
GREEDY,5606,16,2,1,19
GREEDY,2223,14,2,4,20
STINGY,2558,4,0,2,6
GREEDY,3030,18,1,3,22
GREEDY,2595,17,2,2,21
GREEDY,2456,18,1,2,21
GREEDY,3358,18,0,3,21
GREEDY,2736,13,1,3,17
GREEDY,6529,14,2,2,18
GREEDY,2736,14,1,3,18
GREEDY,5014,16,2,3,21
STINGY,1250,2,0,2,4
STINGY,1991,2,0,0,2
GREEDY,5702,18,1,3,22
STINGY,899,6,0,0,6
GREEDY,2384,18,0,2,20
STINGY,1031,4,0,2,6
GREEDY,2414,17,2,3,22
GREEDY,3350,17,2,3,22
STINGY,1394,6,0,0,6
STINGY,1329,2,0,2,4
GREEDY,6149,15,2,3,20
GREEDY,17817,12,2,3,17
STINGY,917,5,0,0,5
GREEDY,2017,17,2,3,22
GREEDY,3904,15,2,4,21
STINGY,1759,2,1,2,5
STINGY,766,4,2,1,7
GREEDY,6010,15,2,2,19
STINGY,937,6,0,2,8
STINGY,2030,2,0,0,2
GREEDY,5471,15,1,4,20
GREEDY,3136,15,1,3,19
GREEDY,3363,19,2,3,24
GREEDY,4229,14,2,2,18
STINGY,1176,5,0,1,6
GREEDY,2778,18,1,4,23
GREEDY,2808,12,2,3,17
GREEDY,3420,17,2,3,22
GREEDY,7801,14,2,4,20
GREEDY,466,13,2,3,18
GREEDY,2352,14,1,4,19
GREEDY,1710,10,2,4,16
GREEDY,1554,15,1,4,20
STINGY,1392,3,1,0,4
GREEDY,2568,16,2,3,21
GREEDY,2613,14,2,3,19
GREEDY,7350,16,2,3,21
GREEDY,2300,15,1,3,19
GREEDY,2050,15,2,2,19
GREEDY,4884,16,2,2,20
GREEDY,3471,18,1,3,22
GREEDY,2997,16,1,2,19
STINGY,1231,4,0,0,4
STINGY,1225,4,0,2,6
STINGY,1620,4,1,0,5
GREEDY,2855,16,2,2,20
GREEDY,4490,19,2,4,25
GREEDY,10007,15,2,3,20
STINGY,59233,8,1,0,9
STINGY,1074,2,1,0,3
GREEDY,5169,16,2,2,20
GREEDY,7085,16,2,3,21
GREEDY,1274,14,2,4,20
GREEDY,2974,15,2,2,19
GREEDY,2566,16,1,4,21
GREEDY,2314,19,1,3,23
GREEDY,2985,17,2,1,20
GREEDY,3731,15,2,4,21
GREEDY,4547,13,2,4,19
GREEDY,3194,17,2,3,22
STINGY,1551,5,1,0,6
STINGY,1797,0,0,0,0
GREEDY,5134,17,1,2,20
GREEDY,2746,18,1,4,23
GREEDY,2510,16,2,4,22
GREEDY,10887,15,1,3,19
STINGY,1044,3,0,0,3
GREEDY,6014,16,2,4,22
STINGY,1175,2,0,1,3
GREEDY,12781,13,2,2,17
GREEDY,2529,13,1,3,17
GREEDY,3938,16,2,4,22
GREEDY,1246,14,0,4,18
GREEDY,2099,15,2,2,19
STINGY,1320,3,0,1,4
GREEDY,2572,17,1,3,21
STINGY,2954,2,1,2,5
STINGY,1788,3,0,0,3
GREEDY,5813,18,2,4,24
GREEDY,7186,17,2,2,21
GREEDY,2856,18,1,3,22
GREEDY,6485,17,2,3,22
GREEDY,4793,15,2,3,20
STINGY,2943,4,0,0,4
STINGY,2051,1,1,0,2
GREEDY,2544,18,1,3,22
STINGY,1535,1,0,1,2
STINGY,539,3,0,2,5
GREEDY,8845,14,2,4,20
GREEDY,3272,18,1,2,21
GREEDY,4025,16,1,3,20
STINGY,1578,4,0,0,4
GREEDY,9960,15,1,2,18
STINGY,1318,3,0,0,3
GREEDY,607,16,0,4,20
STINGY,1492,3,0,1,4
STINGY,2494,4,1,2,7
GREEDY,4225,14,2,4,20
STINGY,1610,0,1,2,3
GREEDY,3358,16,2,3,21
STINGY,2441,1,2,3,6
GREEDY,2597,16,2,2,20
STINGY,1466,3,0,1,4
STINGY,1125,3,1,2,6
STINGY,1342,2,0,0,2
GREEDY,2428,19,2,3,24
STINGY,1402,4,2,0,6
STINGY,565,4,0,2,6
GREEDY,6423,16,1,1,18
STINGY,970,1,0,1,2
GREEDY,8380,14,1,3,18
STINGY,1731,2,0,4,6
GREEDY,6365,17,1,2,20
STINGY,1514,4,1,0,5
STINGY,472,5,0,0,5
GREEDY,4219,16,2,2,20
GREEDY,5507,17,0,4,21
STINGY,1404,5,1,1,7
STINGY,1944,5,0,0,5
GREEDY,10918,15,2,2,19
GREEDY,2508,16,2,4,22
STINGY,750,7,0,0,7
GREEDY,4413,16,1,4,21
STINGY,1680,4,0,0,4
STINGY,1009,3,1,0,4
STINGY,1622,2,0,0,2
GREEDY,3257,17,2,3,22
GREEDY,1784,16,0,4,20
GREEDY,5303,16,1,3,20
STINGY,1834,1,2,0,3
STINGY,1250,1,0,0,1
STINGY,789,5,0,1,6
GREEDY,4091,14,2,3,19
GREEDY,2697,13,1,4,18
STINGY,1897,4,2,1,7
GREEDY,1872,14,2,2,18
GREEDY,4841,15,2,3,20
GREEDY,2592,19,2,2,23
STINGY,949,4,0,1,5
STINGY,917,4,0,3,7
STINGY,1870,3,1,0,4
GREEDY,2366,13,1,4,18
GREEDY,3154,17,1,3,21
STINGY,1330,2,2,0,4
GREEDY,2594,18,1,3,22
GREEDY,1269,13,2,4,19
GREEDY,6261,15,2,3,20
GREEDY,2546,14,1,4,19
STINGY,1211,3,0,1,4
STINGY,1484,0,0,0,0
STINGY,3482,3,0,4,7
STINGY,1751,4,0,1,5
GREEDY,4590,14,1,4,19
STINGY,1588,5,0,0,5
GREEDY,5702,18,2,3,23
GREEDY,3343,18,0,4,22
STINGY,1479,3,0,1,4
STINGY,1713,3,1,0,4
GREEDY,5527,16,1,2,19
GREEDY,4721,16,0,3,19
GREEDY,5311,18,1,2,21
GREEDY,2231,15,1,4,20
STINGY,1578,3,0,1,4
GREEDY,2905,16,2,4,22
GREEDY,7372,18,1,3,22
GREEDY,1432,15,0,4,19
STINGY,1569,1,0,0,1
STINGY,2004,5,0,2,7
STINGY,1269,2,0,2,4
STINGY,1384,1,0,0,1
STINGY,1156,3,0,2,5
STINGY,1355,5,0,1,6
GREEDY,11785,15,1,4,20
GREEDY,16772,15,0,3,18
GREEDY,3491,12,2,4,18
STINGY,1501,2,1,0,3
STINGY,240,5,0,0,5
STINGY,884,7,0,1,8
GREEDY,2558,16,2,4,22
GREEDY,2990,14,2,3,19
STINGY,1745,1,1,0,2
GREEDY,5670,16,2,4,22
GREEDY,2202,20,2,3,25
STINGY,1310,4,0,2,6
GREEDY,3533,16,1,1,18
GREEDY,4133,13,2,3,18
GREEDY,5320,16,1,3,20
STINGY,1091,3,2,0,5
STINGY,1493,3,0,0,3
STINGY,2057,1,1,1,3
GREEDY,4776,17,0,3,20
GREEDY,2215,16,2,2,20
STINGY,1386,2,0,1,3
GREEDY,4287,15,0,3,18
GREEDY,2365,17,2,3,22
GREEDY,3188,14,2,3,19
STINGY,1171,4,0,1,5
STINGY,951,3,0,3,6
GREEDY,1480,13,1,4,18
STINGY,1211,3,0,0,3
GREEDY,2005,20,2,3,25
STINGY,917,5,0,1,6
STINGY,1743,4,0,2,6
GREEDY,5596,17,2,4,23
GREEDY,1032,12,2,2,16
STINGY,1667,2,0,0,2
STINGY,2439,3,0,3,6
STINGY,1036,7,0,0,7
GREEDY,560,8,0,4,12
STINGY,1740,3,0,1,4
STINGY,1174,1,1,0,2
STINGY,1762,5,0,1,6
GREEDY,4503,17,1,3,21
STINGY,1027,2,1,1,4
GREEDY,4092,15,2,3,20
GREEDY,1514,21,2,4,27
GREEDY,2179,19,2,4,25
GREEDY,4798,16,2,3,21
GREEDY,1766,14,1,4,19
STINGY,880,3,0,1,4
GREEDY,2065,17,2,3,22
GREEDY,1407,12,2,3,17
GREEDY,3762,17,0,4,21
GREEDY,3712,16,1,2,19
STINGY,1792,1,0,0,1
STINGY,2130,0,0,1,1
GREEDY,3358,18,2,4,24
GREEDY,5117,16,2,2,20
STINGY,1301,5,0,0,5
GREEDY,6282,16,2,2,20
GREEDY,5146,14,1,3,18
GREEDY,1980,17,2,3,22
GREEDY,3609,17,2,3,22
GREEDY,2240,13,1,4,18
STINGY,482,4,0,1,5
GREEDY,5148,16,1,4,21
GREEDY,2941,16,2,3,21
GREEDY,1808,14,1,3,18
STINGY,2251,3,0,3,6
GREEDY,2419,20,1,3,24
STINGY,1425,1,0,0,1
STINGY,1091,5,1,1,7
STINGY,1957,2,0,0,2
GREEDY,5825,15,2,4,21
STINGY,1619,3,0,0,3
GREEDY,5665,17,2,3,22
GREEDY,4641,12,2,3,17
STINGY,1995,3,1,1,5
STINGY,1043,7,1,1,9
STINGY,1466,5,0,2,7
GREEDY,863,12,1,3,16
STINGY,2177,4,0,2,6
GREEDY,6592,15,2,4,21
GREEDY,3247,16,2,3,21
GREEDY,6075,16,2,4,22
GREEDY,5658,12,1,3,16
GREEDY,6096,14,1,3,18
GREEDY,3767,19,2,3,24
GREEDY,4057,17,2,2,21
STINGY,1807,6,0,1,7
STINGY,1088,2,1,0,3
GREEDY,2866,18,2,3,23
GREEDY,6402,17,2,3,22
STINGY,1555,3,0,0,3
GREEDY,1564,14,2,3,19
GREEDY,5548,13,2,4,19
STINGY,1863,2,0,0,2
GREEDY,3388,17,0,2,19
GREEDY,2783,14,2,3,19
STINGY,1303,2,0,0,2
STINGY,1084,4,0,0,4
GREEDY,2423,17,2,2,21
GREEDY,3168,19,1,3,23
GREEDY,1881,14,2,4,20
STINGY,1235,3,1,0,4
STINGY,1446,3,1,1,5
GREEDY,2394,18,1,2,21
GREEDY,3321,15,0,2,17
GREEDY,2241,15,1,2,18
GREEDY,4497,14,2,4,20
STINGY,1004,4,1,2,7
STINGY,1040,1,0,0,1
GREEDY,6100,15,1,4,20
STINGY,1372,5,1,2,8
STINGY,1551,2,0,0,2
STINGY,2016,3,0,2,5
STINGY,1497,3,1,1,5
GREEDY,6523,19,1,3,23
GREEDY,1693,16,1,4,21
GREEDY,5438,13,2,4,19
GREEDY,7266,11,1,3,15
GREEDY,6537,14,2,2,18
STINGY,1594,2,0,1,3
STINGY,1698,2,0,1,3
STINGY,1511,4,0,0,4
STINGY,1233,0,1,2,3
GREEDY,5400,19,1,2,22
STINGY,2541,3,0,3,6
STINGY,1820,1,0,0,1
STINGY,1589,0,0,1,1
STINGY,1928,3,1,0,4
GREEDY,1969,15,2,2,19
GREEDY,4173,15,2,4,21
GREEDY,2119,15,2,4,21
GREEDY,1781,13,0,4,17
STINGY,2026,0,0,1,1
GREEDY,3798,15,1,3,19
GREEDY,2469,18,2,3,23
GREEDY,2529,15,2,4,21
GREEDY,18708,13,2,3,18
STINGY,1460,7,0,2,9
GREEDY,3031,18,1,2,21
STINGY,1397,2,0,0,2
GREEDY,4523,14,2,3,19
STINGY,1497,6,0,1,7
GREEDY,668,9,1,4,14
STINGY,1570,6,0,2,8
STINGY,1630,0,1,1,2
GREEDY,4720,15,2,4,21
GREEDY,2264,15,1,4,20
GREEDY,3947,18,2,3,23
STINGY,624,8,2,0,10
GREEDY,3310,18,0,4,22
